人民幣	人民幣 ￥
日元	日元 ￥ 💴
日幣	日幣 ￥
美元	美元 $ 💵 💲
美刀	美刀 $
港元	港元 HK$
港幣	港幣 HK$
澳門元	澳門元 MOP$
澳門幣	澳門幣 MOP$
葡幣	葡幣 MOP$
新加坡元	新加坡元 S$
新加坡幣	新加坡幣 S$
歐元	歐元 € 💶
英鎊	英鎊 £ 💷
笑臉	笑臉 😀
露齒笑	露齒笑 😃
哈	哈 😄
哈哈	哈哈 😄
開心	開心 😄
笑	笑 😄 😊
高興	高興 😄
憨憨	憨憨 😄
嘻嘻	嘻嘻 😁
嘿嘿	嘿嘿 😁
咧嘴笑	咧嘴笑 😁
傻笑	傻笑 😆
眯眼笑	眯眼笑 😆
笑死	笑死 😆
好耶	好耶 😆
笑暈	笑暈 😆
汗	汗 😅 😰 😓
冷汗	冷汗 😅 😰 😓
冒汗	冒汗 😅 😰 😓
無語	無語 😅 😰 😓
尷尬	尷尬 😅 😰 😓
苦笑	苦笑 😅
大笑	大笑 🤣 😂
笑哭	笑哭 🤣 😂
笑哭了	笑哭了 🤣 😂
笑出眼淚	笑出眼淚 🤣 😂
打滾	打滾 🤣
打滾兒	打滾兒 🤣
笑得打滾	笑得打滾 🤣
笑得打滾兒	笑得打滾兒 🤣
笑得滿地打滾	笑得滿地打滾 🤣
笑得滿地打滾兒	笑得滿地打滾兒 🤣
呵呵	呵呵 🙂 🙃
倒臉	倒臉 🙃
顛倒	顛倒 🙃
顛倒的臉	顛倒的臉 🙃
消失	消失 🫠 🫥
溶解	溶解 🫠
融化	融化 🫠
眨眼	眨眼 😉
媚眼	媚眼 😉
拋媚眼	拋媚眼 😉
微笑	微笑 😊
臉紅	臉紅 😊 😳
光環	光環 😇
微笑天使	微笑天使 😇
喜笑顏開	喜笑顏開 🥰
愛心環繞	愛心環繞 🥰
愛慕	愛慕 🥰
迷戀	迷戀 🥰
陷入愛河	陷入愛河 🥰
墜入愛河	墜入愛河 🥰
幸福	幸福 🥰
喜歡	喜歡 😍 ♥️
花痴	花痴 😍
崇拜	崇拜 🤩
好崇拜	好崇拜 🤩
好崇拜哦	好崇拜哦 🤩
星星眼	星星眼 🤩
眼冒星星	眼冒星星 🤩
親親	親親 😘
飛吻	飛吻 😘
親一個	親一個 😘
親一下	親一下 😘
啵一個	啵一個 😘
啵兒一個	啵兒一個 😘
噘嘴	噘嘴 😗 🙎‍♂️ 🙎‍♀️
羞澀親親	羞澀親親 😚
微笑親親	微笑親親 😙
含淚的笑臉	含淚的笑臉 🥲
含淚笑臉	含淚笑臉 🥲
欣慰	欣慰 🥲
好吃	好吃 😋
津津有味	津津有味 😋
美味	美味 😋
吐舌	吐舌 😛 😜 😝
吐舌頭	吐舌頭 😛 😜 😝
略略略	略略略 😛 😜 😝
單眼吐舌	單眼吐舌 😜
調皮	調皮 😜
搗蛋	搗蛋 😜
傻瓜	傻瓜 🤪
傻瓜臉	傻瓜臉 🤪
眯眼	眯眼 😝
眯眼吐舌	眯眼吐舌 😝
開玩笑	開玩笑 😝
嘲笑	嘲笑 😝
發財	發財 🤑
財迷	財迷 🤑
拜金	拜金 🤑
見錢眼開	見錢眼開 🤑
錢眼	錢眼 🤑
錢眼兒	錢眼兒 🤑
抱抱	抱抱 🤗 🫂
擁抱	擁抱 🤗 🫂
捂嘴	捂嘴 🤭 🙊
捂嘴巴	捂嘴巴 🤭 🙊
捂上嘴巴	捂上嘴巴 🤭 🙊
捂住嘴巴	捂住嘴巴 🤭 🙊
捂著嘴巴	捂著嘴巴 🤭 🙊
捂嘴笑	捂嘴笑 🤭
捂著嘴笑	捂著嘴笑 🤭
好笑	好笑 🤭
不敢相信	不敢相信 🫢
unbelievable	unbelievable 🫢
偷看	偷看 🫣
偷偷看	偷偷看 🫣
偷瞧	偷瞧 🫣
偷偷瞧	偷偷瞧 🫣
單眼偷看	單眼偷看 🫣
不敢看	不敢看 🫣
我不敢看	我不敢看 🫣
畫面太美我不敢看	畫面太美我不敢看 🫣
那畫面太美我不敢看	那畫面太美我不敢看 🫣
噓	噓 🤫
安靜	安靜 🤫
安靜的臉	安靜的臉 🤫
小聲	小聲 🤫
小點聲	小點聲 🤫
小點兒聲	小點兒聲 🤫
小聲點	小聲點 🤫
小聲點兒	小聲點兒 🤫
別說話	別說話 🤫
深思的臉	深思的臉 🤔
深思	深思 🤔
思考	思考 🤔
奇怪	奇怪 🤔
奇怪了	奇怪了 🤔
想一想	想一想 🤔
想想	想想 🤔
我想想	我想想 🤔
我再想想	我再想想 🤔
容我三思	容我三思 🤔
呃	呃 🤔
疑問	疑問 🤔
可能	可能 🤔
不理解	不理解 🤔
不明白	不明白 🤔
疑惑	疑惑 🤔
敬禮	敬禮 🫡
致敬	致敬 🫡
尊敬	尊敬 🫡
尊重	尊重 🫡
瑞思拜	瑞思拜 🫡
respect	respect 🫡
閉嘴	閉嘴 🤐
秘密	秘密 🤐 ㊙️
保密	保密 🤐
守密	守密 🤐
不說	不說 🤐 🙊
不能說	不能說 🤐
不要說	不要說 🤐
拉上拉鍊	拉上拉鍊 🤐
封口	封口 🤐
禁言	禁言 🤐
挑眉	挑眉 🤨
眉毛上挑	眉毛上挑 🤨
眉毛上挑的臉	眉毛上挑的臉 🤨
平靜	平靜 😐
面無表情	面無表情 😑
沒嘴	沒嘴 😶
沒有嘴	沒有嘴 😶
沒有嘴巴	沒有嘴巴 😶
沉默	沉默 😶
隱形	隱形 🫥
隱藏	隱藏 🫥
虛線臉	虛線臉 🫥
虛線輪廓	虛線輪廓 🫥
雲中	雲中 😶‍🌫️
雲中的臉	雲中的臉 😶‍🌫️
得意	得意 😏
得意地笑	得意地笑 😏
鬱悶	鬱悶 😒
鄙視	鄙視 😒
白眼	白眼 🙄
白眼兒	白眼兒 🙄
翻白眼	翻白眼 🙄
翻白眼兒	翻白眼兒 🙄
咬牙切齒	咬牙切齒 😬
齜牙咧嘴	齜牙咧嘴 😬
齜牙	齜牙 😬
咬牙	咬牙 😬
呼氣	呼氣 😮‍💨 🫁
嘆氣	嘆氣 😮‍💨
唉	唉 😮‍💨
無奈	無奈 😮‍💨
長鼻子	長鼻子 🤥
長鼻	長鼻 🤥
匹諾曹	匹諾曹 🤥
說謊	說謊 🤥
撒謊	撒謊 🤥
亂講	亂講 🤥
胡說	胡說 🤥
騙子	騙子 🤥
騙人	騙人 🤥
騙人布	騙人布 🤥
烏索普	烏索普 🤥
晃腦	晃腦 🫨
搖頭晃腦	搖頭晃腦 🫨
顫抖的臉	顫抖的臉 🫨
猛搖頭	猛搖頭 🫨
甩頭	甩頭 🫨
如釋重負	如釋重負 😌
鬆口氣	鬆口氣 😌
鬆了口氣	鬆了口氣 😌
鬆了一口氣	鬆了一口氣 😌
釋然	釋然 😌
低頭憂傷	低頭憂傷 😔
心事重重	心事重重 😔
憂慮	憂慮 😔
憂傷	憂傷 😔
困	困 😪 🥱
困困	困困 😪
困了	困了 😪 🥱
睏倦	睏倦 😪 🥱
睏乏	睏乏 😪
瞌睡	瞌睡 😪
打瞌睡	打瞌睡 😪
口水	口水 🤤
流口水	流口水 🤤
垂涎三尺	垂涎三尺 🤤
睡覺	睡覺 😴 💤 🛌
睡著	睡著 😴 💤
睡著了	睡著了 😴 💤
睡了	睡了 😴 💤
睡眠	睡眠 😴 💤
口罩	口罩 😷
戴口罩	戴口罩 😷
感冒	感冒 😷 🤧
生病	生病 😷
體溫計	體溫計 🤒
量體溫	量體溫 🤒
發燒	發燒 🤒
受傷	受傷 🤕 ❤️‍🩹
負傷	負傷 🤕
繃帶	繃帶 🤕
纏繃帶	纏繃帶 🤕
纏滿繃帶	纏滿繃帶 🤕
噁心	噁心 🤢
想吐	想吐 🤢
反胃	反胃 🤢
吐	吐 🤮
吐了	吐了 🤮
嘔吐	嘔吐 🤮
吐出來	吐出來 🤮
噴嚏	噴嚏 🤧
打噴嚏	打噴嚏 🤧
鼻涕	鼻涕 🤧
擤鼻涕	擤鼻涕 🤧
擤鼻子	擤鼻子 🤧
鼻炎	鼻炎 🤧
熱	熱 🥵
很熱	很熱 🥵
好熱	好熱 🥵
發熱	發熱 🥵
臉發燒	臉發燒 🥵
辣	辣 🥵
辣死	辣死 🥵
辣死了	辣死了 🥵
超辣	超辣 🥵
超級辣	超級辣 🥵
熱死	熱死 🥵
熱死了	熱死了 🥵
爆辣	爆辣 🥵
冷	冷 🥶
很冷	很冷 🥶
冰冷	冰冷 🥶
好冷	好冷 🥶
冷冰冰	冷冰冰 🥶
冷臉	冷臉 🥶
凍僵	凍僵 🥶
凍僵了	凍僵了 🥶
滿面寒霜	滿面寒霜 🥶
冷死	冷死 🥶
冷死了	冷死了 🥶
凍死	凍死 🥶
凍死了	凍死了 🥶
微醺	微醺 🥴
醉了	醉了 🥴
喝醉	喝醉 🥴
喝醉了	喝醉了 🥴
喝多	喝多 🥴
喝多了	喝多了 🥴
昏昏沉沉	昏昏沉沉 🥴
酒醉	酒醉 🥴
暈	暈 😵 😵‍💫
暈了	暈了 😵 😵‍💫
我暈	我暈 😵 😵‍💫
頭暈	頭暈 😵 😵‍💫
暈頭	暈頭 😵 😵‍💫
頭暈目眩	頭暈目眩 😵 😵‍💫 💫
暈頭轉向	暈頭轉向 😵 😵‍💫
頭暈眼花	頭暈眼花 😵 😵‍💫
爆炸頭	爆炸頭 🤯
爆炸腦	爆炸腦 🤯
頭爆炸	頭爆炸 🤯
腦子爆炸	腦子爆炸 🤯
腦袋爆炸	腦袋爆炸 🤯
腦爆炸	腦爆炸 🤯
大腦爆炸	大腦爆炸 🤯
爆頭	爆頭 🤯
牛仔	牛仔 🤠
牛仔帽	牛仔帽 🤠
牛仔帽臉	牛仔帽臉 🤠
派對	派對 🥳 🎉
派對臉	派對臉 🥳
慶祝	慶祝 🥳 🎉
開趴	開趴 🥳
開淫趴	開淫趴 🥳
開銀趴	開銀趴 🥳
party	party 🥳
開party	開party 🥳
偽裝	偽裝 🥸
偽裝的臉	偽裝的臉 🥸
隱瞞身份	隱瞞身份 🥸
太陽鏡	太陽鏡 😎 🕶
墨鏡	墨鏡 😎 🕶
墨鏡笑臉	墨鏡笑臉 😎
自信	自信 😎
書呆子	書呆子 🤓
書呆子臉	書呆子臉 🤓
單片眼鏡	單片眼鏡 🧐
戴單片眼鏡的臉	戴單片眼鏡的臉 🧐
探究	探究 🧐
研究	研究 🧐
困擾	困擾 😕
不屑	不屑 😕
撇嘴	撇嘴 🫤
不確定	不確定 🫤
擔心	擔心 😟
擔憂	擔憂 😟
不開心	不開心 🙁
不高興	不高興 🙁
不滿	不滿 🙁
微微不滿	微微不滿 🙁
心情不好	心情不好 🙁
不悅	不悅 🙁
一臉不悅	一臉不悅 🙁
吃驚	吃驚 😮 😯 😲 😦 😧
驚訝	驚訝 😮 😯 😲 😦 😧
哦	哦 😮
好奇	好奇 😯
震驚	震驚 😲 😦 😧
啊	啊 😲 😦 😧
害羞	害羞 😳
羞澀	羞澀 😳
愣住	愣住 😳
可憐	可憐 🥺
可憐兮兮	可憐兮兮 🥺
好嘛	好嘛 🥺
求你了	求你了 🥺 🙏
求求你	求求你 🥺 🙏
求求你了	求求你了 🥺 🙏
忍住淚水	忍住淚水 🥹
強忍淚水	強忍淚水 🥹
要哭了	要哭了 🥹
含淚	含淚 🥹
委屈	委屈 🥹
目瞪口呆	目瞪口呆 😦
怕	怕 😨 😱
可怕	可怕 😨 😱
害怕	害怕 😨 😱
恐懼	恐懼 😨 😱
焦慮	焦慮 😰 😩
冒汗焦慮	冒汗焦慮 😰
緊張	緊張 😰
失望但如釋重負	失望但如釋重負 😥
難過但釋然	難過但釋然 😥
哭	哭 😢 😭
哭了	哭了 😢 😭
哭泣	哭泣 😢 😭
流淚	流淚 😢 😭
流眼淚	流眼淚 😢 😭
大哭	大哭 😭
放聲大哭	放聲大哭 😭
痛哭	痛哭 😭
嚇死	嚇死 😱
嚇死了	嚇死了 😱
嚇人	嚇人 😱
尖叫	尖叫 😱
恐怖	恐怖 😱
恐懼尖叫	恐懼尖叫 😱
驚聲尖叫	驚聲尖叫 😱
焦頭爛額	焦頭爛額 😖
糾結	糾結 😖
忍耐	忍耐 😣
失望	失望 😞
難過	難過 😞
倒黴	倒黴 😓
疲倦	疲倦 😩
疲勞	疲勞 😩
疲憊	疲憊 😩
焦躁	焦躁 😩
抓狂	抓狂 😫
呵欠	呵欠 🥱
哈欠	哈欠 🥱
打哈欠	打哈欠 🥱
打呵欠	打呵欠 🥱
傲慢	傲慢 😤
趾高氣昂	趾高氣昂 😤
鼻子冒氣	鼻子冒氣 😤
哼	哼 😤
哼哼	哼哼 😤
怒	怒 😡 😠 💢
憤怒	憤怒 😡 😠 💢
生氣	生氣 😡 😠 💢
氣人	氣人 😡 😠
angry	angry 😡 😠 💢
發火	發火 😡
發飆	發飆 😡
怒火中燒	怒火中燒 😡
煩死	煩死 😡
煩死人	煩死人 😡
煩死了	煩死了 😡
煩死啦	煩死啦 😡
微怒	微怒 😠
罵人	罵人 🤬
咒罵	咒罵 🤬
髒話	髒話 🤬
說髒話	說髒話 🤬
你媽死了	你媽死了 🤬
NMSL	NMSL 🤬
肏你媽	肏你媽 🤬
操你媽	操你媽 🤬
傻逼	傻逼 🤬
出口成髒	出口成髒 🤬
惡魔	惡魔 😈 👿
魔鬼	魔鬼 😈 👿
微笑惡魔	微笑惡魔 😈
惡魔微笑	惡魔微笑 😈
微笑的惡魔	微笑的惡魔 😈
生氣惡魔	生氣惡魔 👿
惡魔生氣	惡魔生氣 👿
生氣的惡魔	生氣的惡魔 👿
頭骨	頭骨 💀 ☠️
骷髏	骷髏 💀 ☠️
骷髏頭	骷髏頭 💀 ☠️
死亡	死亡 💀 ☠️
屎	屎 💩
拉屎	拉屎 💩
大便	大便 💩
拉大便	拉大便 💩
便便	便便 💩
拉便便	拉便便 💩
粑粑	粑粑 💩
拉粑粑	拉粑粑 💩
小丑	小丑 🤡
小丑臉	小丑臉 🤡
怪物	怪物 👹
妖怪	妖怪 👺
鬼	鬼 👻
鬼魂	鬼魂 👻
幽靈	幽靈 👻
外星人	外星人 👽
怪獸	怪獸 👾
異形怪獸	異形怪獸 👾
外星怪物	外星怪物 👾
機器人	機器人 🤖
開心貓	開心貓 😺
開心的貓	開心的貓 😺
開心貓臉	開心貓臉 😺
微笑貓	微笑貓 😸
微笑的貓	微笑的貓 😸
微笑貓臉	微笑貓臉 😸
笑中帶淚	笑中帶淚 😹
喜極而泣	喜極而泣 😹
笑出眼淚的貓	笑出眼淚的貓 😹
花痴貓	花痴貓 😻
花痴的貓	花痴的貓 😻
花痴貓臉	花痴貓臉 😻
得意貓	得意貓 😼
得意的貓	得意的貓 😼
得意貓臉	得意貓臉 😼
親親貓	親親貓 😽
親親的貓	親親的貓 😽
親親貓臉	親親貓臉 😽
恐懼貓	恐懼貓 🙀
恐懼的貓	恐懼的貓 🙀
恐懼貓臉	恐懼貓臉 🙀
害怕貓	害怕貓 🙀
害怕的貓	害怕的貓 🙀
害怕貓臉	害怕貓臉 🙀
哭泣貓	哭泣貓 😿
哭泣的貓	哭泣的貓 😿
哭泣貓臉	哭泣貓臉 😿
生氣貓	生氣貓 😾
生氣的貓	生氣的貓 😾
生氣貓臉	生氣貓臉 😾
噘嘴貓	噘嘴貓 😾
噘嘴的貓	噘嘴的貓 😾
噘嘴貓臉	噘嘴貓臉 😾
非禮勿視	非禮勿視 🙈
不看	不看 🙈
矇眼	矇眼 🙈
矇眼睛	矇眼睛 🙈
矇住眼睛	矇住眼睛 🙈
我不看	我不看 🙈
非禮勿聽	非禮勿聽 🙉
不聽	不聽 🙉
堵耳	堵耳 🙉
堵耳朵	堵耳朵 🙉
堵上耳朵	堵上耳朵 🙉
堵住耳朵	堵住耳朵 🙉
堵著耳朵	堵著耳朵 🙉
捂耳	捂耳 🙉
捂耳朵	捂耳朵 🙉
捂上耳朵	捂上耳朵 🙉
捂住耳朵	捂住耳朵 🙉
捂著耳朵	捂著耳朵 🙉
我不聽	我不聽 🙉
非禮勿言	非禮勿言 🙊
情書	情書 💌
一箭穿心	一箭穿心 💘
丘比特	丘比特 💘
心中箭了	心中箭了 💘
愛的禮物	愛的禮物 💝
繫有緞帶的心	繫有緞帶的心 💝
飾以絲帶的心	飾以絲帶的心 💝
送你一顆心	送你一顆心 💝
閃亮的心	閃亮的心 💖
愛心	愛心 💖 ♥️
膨脹的心	膨脹的心 💗
膨脹的愛心	膨脹的愛心 💗
搏動的心	搏動的心 💗
心動	心動 💓
心跳	心跳 💓
愛情	愛情 💓 💕 👩‍❤️‍👨
love	love 💓 💕 👩‍❤️‍👨 ♥️
旋轉的心	旋轉的心 💞
舞動的心	舞動的心 💞
心連心	心連心 💞
兩顆心	兩顆心 💕
粉色的心	粉色的心 💕 🩷
心形	心形 💟 ♥️
心形裝飾	心形裝飾 💟
心歎號	心歎號 ❣️
傷心	傷心 💔
心碎	心碎 💔
失戀	失戀 💔
火上之心	火上之心 ❤️‍🔥
心火	心火 ❤️‍🔥
燃燒的心	燃燒的心 ❤️‍🔥
心在燃燒	心在燃燒 ❤️‍🔥
心在著火	心在著火 ❤️‍🔥
愛火	愛火 ❤️‍🔥
修復受傷的心靈	修復受傷的心靈 ❤️‍🩹
治癒的心	治癒的心 ❤️‍🩹
受傷的心	受傷的心 ❤️‍🩹
受傷的心靈	受傷的心靈 ❤️‍🩹
心傷	心傷 ❤️‍🩹
粉心	粉心 🩷
粉色心	粉色心 🩷
粉紅心	粉紅心 🩷
橙心	橙心 🧡
橙色心	橙色心 🧡
橙色的心	橙色的心 🧡
橘心	橘心 🧡
橘色心	橘色心 🧡
橘色的心	橘色的心 🧡
黃心	黃心 💛
黃色心	黃色心 💛
黃色的心	黃色的心 💛
綠心	綠心 💚
綠色心	綠色心 💚
綠色的心	綠色的心 💚
藍心	藍心 💙 🩵
藍色心	藍色心 💙 🩵
藍色的心	藍色的心 💙 🩵
淡藍心	淡藍心 🩵
淡藍色心	淡藍色心 🩵
淡藍色的心	淡藍色的心 🩵
紫心	紫心 💜
紫色心	紫色心 💜
紫色的心	紫色的心 💜
棕心	棕心 🤎
棕色心	棕色心 🤎
棕色的心	棕色的心 🤎
黑心	黑心 🖤
黑色心	黑色心 🖤
黑色的心	黑色的心 🖤
灰心	灰心 🩶
灰色心	灰色心 🩶
灰色的心	灰色的心 🩶
白心	白心 🤍
白色心	白色心 🤍
白色的心	白色的心 🤍
親	親 💋
吻	吻 💋
親吻	親吻 💋
親嘴	親嘴 💋
唇	唇 💋 👄
唇印	唇印 💋
紅唇	紅唇 💋 👄
吻痕	吻痕 💋
kiss	kiss 💋
麼麼	麼麼 💋
麼麼噠	麼麼噠 💋
一百	一百 💯
一百分	一百分 💯
滿分	滿分 💯
火大	火大 💢
青筋	青筋 💢
生氣符號	生氣符號 💢
爆炸	爆炸 💥
水珠	水珠 💦 💧
水滴	水滴 💦 💧
陣風	陣風 💨
尾氣	尾氣 💨
汽車尾氣	汽車尾氣 💨
坑	坑 🕳
洞	洞 🕳
下水道	下水道 🕳
對話氣泡	對話氣泡 💬 🗨 🗯
對話框	對話框 💬 🗨 🗯 💭
證人	證人 👁️‍🗨️
我是證人	我是證人 👁️‍🗨️
朝左的對話氣泡	朝左的對話氣泡 🗨
憤怒對話氣泡	憤怒對話氣泡 🗯
憤怒對話框	憤怒對話框 🗯
思考氣泡	思考氣泡 💭
內心活動氣泡	內心活動氣泡 💭
睡眠符號	睡眠符號 💤
ZZZ	ZZZ 💤
揮手	揮手 👋
擺手	擺手 👋
你好	你好 👋
再見	再見 👋
拜拜	拜拜 👋
手背	手背 🤚
手指張開	手指張開 🖐
手指張開的手	手指張開的手 🖐
舉起的手	舉起的手 ✋
手掌	手掌 ✋
擊掌	擊掌 ✋
手	手 ✋
瓦肯舉手禮	瓦肯舉手禮 🖖
瓦肯	瓦肯 🖖
斯波克	斯波克 🖖
星際迷航	星際迷航 🖖
右手	右手 🫱 🫸
向右的手	向右的手 🫱
向右伸的手	向右伸的手 🫱
朝右	朝右 🫱
左手	左手 🫲 🫷
向左的手	向左的手 🫲
向左伸的手	向左伸的手 🫲
朝左	朝左 🫲
手掌朝下	手掌朝下 🫳
掌心朝下	掌心朝下 🫳
朝下	朝下 🫳
放手	放手 🫳
手掌朝上	手掌朝上 🫴
掌心朝上	掌心朝上 🫴
朝上	朝上 🫴
伸手	伸手 🫴
抬起	抬起 🫴
左推	左推 🫷
向左推	向左推 🫷
推手	推手 🫷 🫸
向左推手	向左推手 🫷
向左推的手	向左推的手 🫷
右推	右推 🫸
向右推	向右推 🫸
向右推手	向右推手 🫸
向右推的手	向右推的手 🫸
OK	OK 👌 🙆‍♂️ 🙆‍♀️ 🆗
好	好 👌 🙆‍♂️ 🙆‍♀️
好的	好的 👌 🙆‍♂️ 🙆‍♀️
好噠	好噠 👌
沒問題	沒問題 👌
手指捏和	手指捏和 🤌
捏合	捏合 🤌
蘭花指	蘭花指 🤌
捏手指	捏手指 🤌
手指	手指 🤌
一點	一點 🤏 🕐
一點兒	一點兒 🤏
一點點	一點點 🤏
少量	少量 🤏
少許	少許 🤏
和平手勢	和平手勢 ✌️
耶	耶 ✌️
哦耶	哦耶 ✌️
成功	成功 ✌️
勝利	勝利 ✌️
贏了	贏了 ✌️
剪刀手	剪刀手 ✌️
贏啦	贏啦 ✌️
贏咯	贏咯 ✌️
兩個	兩個 ✌️
第二	第二 ✌️
手指交叉	手指交叉 🤞
交叉的手指	交叉的手指 🤞
食指和拇指交叉的手	食指和拇指交叉的手 🫰
響指	響指 🫰
打響指	打響指 🫰
比心	比心 🫰 🫶
比心手勢	比心手勢 🫰 🫶
愛你手勢	愛你手勢 🤟
愛你的手勢	愛你的手勢 🤟
愛你	愛你 🤟
我愛你	我愛你 🤟
搖滾	搖滾 🤘
搖滾手勢	搖滾手勢 🤘
金屬禮	金屬禮 🤘
打電話	打電話 🤙
回電話	回電話 🤙
打給我	打給我 🤙
給我打電話	給我打電話 🤙
打電話給我	打電話給我 🤙
六六六	六六六 🤙
反手食指向左指	反手食指向左指 👈
向左指	向左指 👈
向左	向左 👈
往左	往左 👈
往左指	往左指 👈
左面	左面 👈
左邊	左邊 👈
反手食指向右指	反手食指向右指 👉
向右指	向右指 👉
向右	向右 👉
往右	往右 👉
往右指	往右指 👉
右面	右面 👉
右邊	右邊 👉
反手食指向上指	反手食指向上指 👆
向上指	向上指 👆
向上	向上 👆
往上	往上 👆
往上指	往上指 👆
上面	上面 👆
上邊	上邊 👆
反手食指向下指	反手食指向下指 👇
向下指	向下指 👇
向下	向下 👇
往下	往下 👇
往下指	往下指 👇
下面	下面 👇
下邊	下邊 👇
中指	中指 🖕
豎中指	豎中指 🖕
比中指	比中指 🖕
舉中指	舉中指 🖕
食指	食指 ☝️
一個	一個 ☝️
第一	第一 ☝️
食指指向觀察者	食指指向觀察者 🫵
指向觀察者的食指	指向觀察者的食指 🫵
你自己	你自己 🫵
就是你	就是你 🫵
指著	指著 🫵
指著你	指著你 🫵
指你	指你 🫵
指我	指我 🫵
指人	指人 🫵
拇指	拇指 👍 👎
大拇指	大拇指 👍 👎
大拇指向上	大拇指向上 👍
拇指向上	拇指向上 👍 👎
大拇指朝上	大拇指朝上 👍
拇指朝上	拇指朝上 👍
強	強 👍
好強	好強 👍
棒	棒 👍
棒啊	棒啊 👍
真棒	真棒 👍
好棒	好棒 👍
很棒	很棒 👍
特棒	特棒 👍
非常棒	非常棒 👍
棒棒	棒棒 👍
棒棒的	棒棒的 👍
棒棒噠	棒棒噠 👍
太棒	太棒 👍
太棒了	太棒了 👍
太棒啦	太棒啦 👍
幹得好	幹得好 👍
很好	很好 👍
不錯	不錯 👍
表揚	表揚 👍
牛逼	牛逼 👍
厲害	厲害 👍
贊	贊 👍
點贊	點贊 👍
絕了	絕了 👍
大拇指向下	大拇指向下 👎
大拇指朝下	大拇指朝下 👎
拇指朝下	拇指朝下 👎
不好	不好 👎
不強	不強 👎
不棒	不棒 👎
很差	很差 👎
太差	太差 👎
太差了	太差了 👎
太差啦	太差啦 👎
差勁	差勁 👎
舉起拳頭	舉起拳頭 ✊
舉起的拳頭	舉起的拳頭 ✊
握拳	握拳 ✊
握緊的拳頭	握緊的拳頭 👊
拳頭	拳頭 👊
出拳	出拳 👊
打擊	打擊 👊
重拳出擊	重拳出擊 👊
打你	打你 👊
揍你	揍你 👊
幹你	幹你 👊
左向拳	左向拳 🤛
朝左的拳頭	朝左的拳頭 🤛
右鉤拳	右鉤拳 🤛
右拳	右拳 🤛
右向拳	右向拳 🤜
朝右的拳頭	朝右的拳頭 🤜
左鉤拳	左鉤拳 🤜
左拳	左拳 🤜
鼓掌	鼓掌 👏
拍手	拍手 👏
拍掌	拍掌 👏
啪啪啪	啪啪啪 👏
揚手歡呼	揚手歡呼 🙌
舉雙手	舉雙手 🙌
做成心形的雙手	做成心形的雙手 🫶
雙手張開	雙手張開 👐
張開雙手	張開雙手 👐
雙手手掌向上	雙手手掌向上 🤲
掌心向上托起	掌心向上托起 🤲
雙手	雙手 🤲
捧著	捧著 🤲
握手	握手 🤝
合作	合作 🤝
合作愉快	合作愉快 🤝
搞定	搞定 🤝
雙手合十	雙手合十 🙏
合十	合十 🙏
合掌	合掌 🙏
拜託	拜託 🙏
祈求	祈求 🙏
祈禱	祈禱 🙏
感謝	感謝 🙏
謝謝	謝謝 🙏
超度	超度 🙏
阿彌陀佛	阿彌陀佛 🙏
寫字	寫字 ✍️
手寫	手寫 ✍️
指甲油	指甲油 💅
塗指甲油	塗指甲油 💅
美甲	美甲 💅
做指甲	做指甲 💅
做美甲	做美甲 💅
自拍	自拍 🤳
二頭肌	二頭肌 💪
肱二頭肌	肱二頭肌 💪
肱二頭	肱二頭 💪
強壯	強壯 💪
肌肉	肌肉 💪
秀肌肉	秀肌肉 💪
健身	健身 💪
加油	加油 💪 ⛽
奮鬥	奮鬥 💪
努力	努力 💪
義肢	義肢 🦾 🦿
義體	義體 🦾 🦿
賽博朋克	賽博朋克 🦾 🦿
機械手臂	機械手臂 🦾
機械臂	機械臂 🦾
機械腿	機械腿 🦿
腿	腿 🦵
腿兒	腿兒 🦵
大腿	大腿 🦵
練腿	練腿 🦵
腳	腳 🦶
足	足 🦶
踢	踢 🦶
踩	踩 🦶
腳丫	腳丫 🦶
腳丫子	腳丫子 🦶
聽	聽 👂
耳	耳 👂
耳朵	耳朵 👂
助聽器	助聽器 🦻
聽力障礙	聽力障礙 🦻
戴助聽器的耳朵	戴助聽器的耳朵 🦻
嗅	嗅 👃
聞	聞 👃
鼻	鼻 👃
鼻子	鼻子 👃
呼吸	呼吸 👃
大腦	大腦 🧠
頭腦	頭腦 🧠
腦花	腦花 🧠
腦子	腦子 🧠
腦	腦 🧠
心臟	心臟 🫀
心臟器官	心臟器官 🫀
肺	肺 🫁
吸氣	吸氣 🫁
呼吸作用	呼吸作用 🫁
牙	牙 🦷
牙齒	牙齒 🦷
牙牙	牙牙 🦷
骨頭	骨頭 🦴
骨骼	骨骼 🦴
眼	眼 👀 👁
眼睛	眼睛 👀 👁
注視	注視 👀
觀察	觀察 👀
看	看 👀
看看	看看 👀
單眼	單眼 👁
一隻眼	一隻眼 👁
一隻眼睛	一隻眼睛 👁
瞳孔	瞳孔 👁
舌	舌 👅
舌頭	舌頭 👅
口	口 👄
嘴	嘴 👄
嘴唇	嘴唇 👄
嘴巴	嘴巴 👄
咬嘴唇	咬嘴唇 🫦
咬住嘴唇	咬住嘴唇 🫦
調情	調情 🫦
情調	情調 🫦
誘惑	誘惑 🫦
嬰兒	嬰兒 👶 🚼
寶寶	寶寶 👶 🚼
小寶貝	小寶貝 👶
小寶貝兒	小寶貝兒 👶
baby	baby 👶 🚼
乖寶	乖寶 👶
乖寶寶	乖寶寶 👶
兒童	兒童 🧒
小孩	小孩 🧒
小孩兒	小孩兒 🧒
孩子	孩子 🧒
小孩子	小孩子 🧒
小朋友	小朋友 🧒
小盆友	小盆友 🧒
男孩	男孩 👦
小男孩	小男孩 👦
兒子	兒子 👦
女孩	女孩 👧
小女孩	小女孩 👧
女兒	女兒 👧
金髮	金髮 👱 👱‍♀️ 👱‍♂️
金色頭髮	金色頭髮 👱 👱‍♀️ 👱‍♂️
金髮女	金髮女 👱 👱‍♀️
金髮女子	金髮女子 👱 👱‍♀️
金髮女人	金髮女人 👱 👱‍♀️
男人	男人 👨
成年男人	成年男人 👨
成年男性	成年男性 👨
爸爸	爸爸 👨
父親	父親 👨
老爹	老爹 👨
有鬍鬚的人	有鬍鬚的人 🧔
有鬍子的人	有鬍子的人 🧔
絡腮鬍	絡腮鬍 🧔
鬍子	鬍子 🧔
鬍鬚	鬍鬚 🧔
大叔	大叔 🧔
長鬍子的女人	長鬍子的女人 🧔‍♀️
鬍子女	鬍子女 🧔‍♀️
紅髮	紅髮 👨‍🦰 👩‍🦰 🦰
紅色頭髮	紅色頭髮 👨‍🦰 👩‍🦰 🦰
紅髮男	紅髮男 👨‍🦰 👨‍🦱
紅髮男子	紅髮男子 👨‍🦰 👨‍🦱
紅髮男人	紅髮男人 👨‍🦰 👨‍🦱
捲髮	捲髮 👨‍🦱 👩‍🦱 🦱
白髮	白髮 👨‍🦳 👩‍🦳 🦳
白色頭髮	白色頭髮 👨‍🦳 👩‍🦳
白髮男	白髮男 👨‍🦳
白髮男子	白髮男子 👨‍🦳
白髮男人	白髮男人 👨‍🦳
光頭	光頭 👨‍🦲 👩‍🦲 🦲
光頭男	光頭男 👨‍🦲
光頭男子	光頭男子 👨‍🦲
光頭男人	光頭男人 👨‍🦲
禿頂	禿頂 👨‍🦲 👩‍🦲 🦲
禿頭	禿頭 👨‍🦲 👩‍🦲 🦲
頭禿	頭禿 👨‍🦲 👩‍🦲 🦲
脫髮	脫髮 👨‍🦲 👩‍🦲 🦲
和尚	和尚 👨‍🦲
女人	女人 👩
成年女人	成年女人 👩
成年女性	成年女性 👩
媽媽	媽媽 👩
母親	母親 👩
老媽	老媽 👩
紅頭髮	紅頭髮 👩‍🦰 🦰
紅髮女	紅髮女 👩‍🦰
紅髮女子	紅髮女子 👩‍🦰
紅髮女人	紅髮女人 👩‍🦰
捲髮女	捲髮女 👩‍🦱
捲髮女子	捲髮女子 👩‍🦱
捲髮女人	捲髮女人 👩‍🦱
白髮女	白髮女 👩‍🦳
白髮女子	白髮女子 👩‍🦳
白髮女人	白髮女人 👩‍🦳
光頭女	光頭女 👩‍🦲
光頭女子	光頭女子 👩‍🦲
光頭女人	光頭女人 👩‍🦲
尼姑	尼姑 👩‍🦲
金髮男	金髮男 👱‍♂️
金髮男子	金髮男子 👱‍♂️
金髮男人	金髮男人 👱‍♂️
老人	老人 👴 👵
老頭	老頭 👴
老頭兒	老頭兒 👴
老爺爺	老爺爺 👴
爺爺	爺爺 👴
姥爺	姥爺 👴
外公	外公 👴
祖父	祖父 👴
老太太	老太太 👵
老奶奶	老奶奶 👵
奶奶	奶奶 👵
姥姥	姥姥 👵
外婆	外婆 👵
祖母	祖母 👵
皺著眉頭	皺著眉頭 🙍‍♂️ 🙍‍♀️
皺著眉頭的人	皺著眉頭的人 🙍‍♂️ 🙍‍♀️
噘嘴的人	噘嘴的人 🙎‍♂️ 🙎‍♀️
禁止手勢	禁止手勢 🙅‍♂️ 🙅‍♀️
不	不 🙅‍♂️ 🙅‍♀️
不行	不行 🙅‍♂️ 🙅‍♀️
反對	反對 🙅‍♂️ 🙅‍♀️
拒絕	拒絕 🙅‍♂️ 🙅‍♀️
不同意	不同意 🙅‍♂️ 🙅‍♀️
不可以	不可以 🙅‍♂️ 🙅‍♀️
打咩	打咩 🙅‍♂️ 🙅‍♀️
同意	同意 🙆‍♂️ 🙆‍♀️
可以	可以 🙆‍♂️ 🙆‍♀️ 🉑
服務員	服務員 💁‍♂️ 💁‍♀️
服務生	服務生 💁‍♂️ 💁‍♀️
男服務員	男服務員 💁‍♂️
男服務生	男服務生 💁‍♂️
女服務員	女服務員 💁‍♀️
女服務生	女服務生 💁‍♀️
舉手	舉手 🙋‍♂️ 🙋‍♀️
我知道	我知道 🙋‍♂️ 🙋‍♀️
這個我知道	這個我知道 🙋‍♂️ 🙋‍♀️
失聰者	失聰者 🧏‍♂️ 🧏‍♀️
失聰	失聰 🧏‍♂️ 🧏‍♀️
耳聾	耳聾 🧏‍♂️ 🧏‍♀️
聾子	聾子 🧏‍♂️ 🧏‍♀️
不好意思	不好意思 🙇‍♂️ 🙇‍♀️
對不起	對不起 🙇‍♂️ 🙇‍♀️
道歉	道歉 🙇‍♂️ 🙇‍♀️
鞠躬	鞠躬 🙇‍♂️ 🙇‍♀️
跪求	跪求 🙇‍♂️ 🙇‍♀️
捂臉	捂臉 🤦‍♂️ 🤦‍♀️
手掌捂臉	手掌捂臉 🤦‍♂️ 🤦‍♀️
扶額	扶額 🤦‍♂️ 🤦‍♀️
服了	服了 🤦‍♂️ 🤦‍♀️
我服了	我服了 🤦‍♂️ 🤦‍♀️
服了你了	服了你了 🤦‍♂️ 🤦‍♀️
我服了你	我服了你 🤦‍♂️ 🤦‍♀️
我服了你了	我服了你了 🤦‍♂️ 🤦‍♀️
聳肩	聳肩 🤷‍♂️ 🤷‍♀️
不關心	不關心 🤷‍♂️ 🤷‍♀️
不知道	不知道 🤷‍♂️ 🤷‍♀️
誰知道	誰知道 🤷‍♂️ 🤷‍♀️
誰知道呢	誰知道呢 🤷‍♂️ 🤷‍♀️
與我無關	與我無關 🤷‍♂️ 🤷‍♀️
醫護人員	醫護人員 👨‍⚕️ 👩‍⚕️
醫生	醫生 👨‍⚕️ 👩‍⚕️
男醫護人員	男醫護人員 👨‍⚕️
男醫生	男醫生 👨‍⚕️
大夫	大夫 👨‍⚕️ 👩‍⚕️
男大夫	男大夫 👨‍⚕️
女醫護人員	女醫護人員 👩‍⚕️
女醫生	女醫生 👩‍⚕️
女大夫	女大夫 👩‍⚕️
學生	學生 👨‍🎓 👩‍🎓
大學生	大學生 👨‍🎓 👩‍🎓
男學生	男學生 👨‍🎓
畢業	畢業 👨‍🎓 👩‍🎓
本科生	本科生 👨‍🎓 👩‍🎓
女學生	女學生 👩‍🎓
老師	老師 👨‍🏫 👩‍🏫
教師	教師 👨‍🏫 👩‍🏫
男老師	男老師 👨‍🏫
男教師	男教師 👨‍🏫
女老師	女老師 👩‍🏫
女教師	女教師 👩‍🏫
法官	法官 👨‍⚖️ 👩‍⚖️
男法官	男法官 👨‍⚖️
女法官	女法官 👩‍⚖️
農民	農民 👨‍🌾 👩‍🌾
農夫	農夫 👨‍🌾
農婦	農婦 👩‍🌾
做飯	做飯 👨‍🍳 👩‍🍳
廚師	廚師 👨‍🍳 👩‍🍳
大廚	大廚 👨‍🍳 👩‍🍳
男廚師	男廚師 👨‍🍳
下廚	下廚 👨‍🍳 👩‍🍳
女廚師	女廚師 👩‍🍳
技工	技工 👨‍🔧 👩‍🔧
水管工	水管工 👨‍🔧 👩‍🔧
電工	電工 👨‍🔧 👩‍🔧
修理工	修理工 👨‍🔧 👩‍🔧
男技工	男技工 👨‍🔧
男水管工	男水管工 👨‍🔧
男電工	男電工 👨‍🔧
男修理工	男修理工 👨‍🔧
女技工	女技工 👩‍🔧
女水管工	女水管工 👩‍🔧
女電工	女電工 👩‍🔧
女修理工	女修理工 👩‍🔧
工廠工人	工廠工人 👨‍🏭 👩‍🏭
男工廠工人	男工廠工人 👨‍🏭
女工廠工人	女工廠工人 👩‍🏭
辦公室職員	辦公室職員 👨‍💼 👩‍💼
職員	職員 👨‍💼 👩‍💼
白領	白領 👨‍💼 👩‍💼
男辦公室職員	男辦公室職員 👨‍💼
男職員	男職員 👨‍💼
男白領	男白領 👨‍💼
女辦公室職員	女辦公室職員 👩‍💼
女職員	女職員 👩‍💼
女白領	女白領 👩‍💼
科學家	科學家 👨‍🔬 👩‍🔬
化學家	化學家 👨‍🔬 👩‍🔬
男科學家	男科學家 👨‍🔬
男化學家	男化學家 👨‍🔬
女科學家	女科學家 👩‍🔬
女化學家	女化學家 👩‍🔬
程序員	程序員 👨‍💻 👩‍💻
碼農	碼農 👨‍💻 👩‍💻
碼畜	碼畜 👨‍💻 👩‍💻
開發人員	開發人員 👨‍💻 👩‍💻
技術員	技術員 👨‍💻 👩‍💻
男程序員	男程序員 👨‍💻
男碼農	男碼農 👨‍💻
男碼畜	男碼畜 👨‍💻
男開發人員	男開發人員 👨‍💻
男技術員	男技術員 👨‍💻
女程序員	女程序員 👩‍💻
女碼農	女碼農 👩‍💻
女碼畜	女碼畜 👩‍💻
女開發人員	女開發人員 👩‍💻
女技術員	女技術員 👩‍💻
歌手	歌手 👨‍🎤 👩‍🎤
男歌手	男歌手 👨‍🎤
搖滾歌手	搖滾歌手 👨‍🎤 👩‍🎤
搖滾男歌手	搖滾男歌手 👨‍🎤
男搖滾歌手	男搖滾歌手 👨‍🎤
朋克	朋克 👨‍🎤 👩‍🎤
重金屬	重金屬 👨‍🎤 👩‍🎤
女歌手	女歌手 👩‍🎤
搖滾女歌手	搖滾女歌手 👩‍🎤
女搖滾歌手	女搖滾歌手 👩‍🎤
藝術家	藝術家 👨‍🎨 👩‍🎨
男藝術家	男藝術家 👨‍🎨
畫家	畫家 👨‍🎨 👩‍🎨
男畫家	男畫家 👨‍🎨
漫畫家	漫畫家 👨‍🎨 👩‍🎨
男漫畫家	男漫畫家 👨‍🎨
女藝術家	女藝術家 👩‍🎨
女畫家	女畫家 👩‍🎨
女漫畫家	女漫畫家 👩‍🎨
飛行員	飛行員 👨‍✈️ 👩‍✈️
男飛行員	男飛行員 👨‍✈️
女飛行員	女飛行員 👩‍✈️
宇航員	宇航員 👨‍🚀 👩‍🚀
男宇航員	男宇航員 👨‍🚀
女宇航員	女宇航員 👩‍🚀
消防員	消防員 👨‍🚒 👩‍🚒
男消防員	男消防員 👨‍🚒
女消防員	女消防員 👩‍🚒
警官	警官 👮‍♂️ 👮‍♀️
警察	警察 👮‍♂️ 👮‍♀️
男警官	男警官 👮‍♂️
男警察	男警察 👮‍♂️
女警官	女警官 👮‍♀️
女警察	女警察 👮‍♀️
偵探	偵探 🕵️‍♂️ 🕵️‍♀️
男偵探	男偵探 🕵️‍♂️
女偵探	女偵探 🕵️‍♀️
衛兵	衛兵 💂‍♂️ 💂‍♀️
衛士	衛士 💂‍♂️ 💂‍♀️
男衛兵	男衛兵 💂‍♂️
男衛士	男衛士 💂‍♂️
女衛兵	女衛兵 💂‍♀️
女衛士	女衛士 💂‍♀️
忍者	忍者 🥷
忍術	忍術 🥷
工人	工人 👷‍♂️ 👷‍♀️
建築工	建築工 👷‍♂️ 👷‍♀️
建築工人	建築工人 👷‍♂️ 👷‍♀️
農民工	農民工 👷‍♂️ 👷‍♀️
男工人	男工人 👷‍♂️
男建築工	男建築工 👷‍♂️
男建築工人	男建築工人 👷‍♂️
男農民工	男農民工 👷‍♂️
女工人	女工人 👷‍♀️
女建築工	女建築工 👷‍♀️
女建築工人	女建築工人 👷‍♀️
女農民工	女農民工 👷‍♀️
君主	君主 🫅
戴王冠的人	戴王冠的人 🫅
王子	王子 🤴
小王子	小王子 🤴
國王	國王 🤴
公主	公主 👸
小公主	小公主 👸
女王	女王 👸
女皇	女皇 👸
頭巾	頭巾 👳‍♂️ 👳‍♀️ 🧕
戴頭巾	戴頭巾 👳‍♂️ 👳‍♀️
戴頭巾的人	戴頭巾的人 👳‍♂️ 👳‍♀️
中國帽	中國帽 👲
瓜皮帽	瓜皮帽 👲
地主	地主 👲
穆斯林	穆斯林 🧕
新郎	新郎 🤵‍♂️
禮服	禮服 🤵‍♂️
燕尾服	燕尾服 🤵‍♂️
西服	西服 🤵‍♂️
西裝	西裝 🤵‍♂️
女新郎	女新郎 🤵‍♀️
男新娘	男新娘 👰‍♂️
戴頭紗的人	戴頭紗的人 👰‍♀️
頭紗	頭紗 👰‍♀️
婚紗	婚紗 👰‍♀️
新娘	新娘 👰‍♀️
新娘子	新娘子 👰‍♀️
孕婦	孕婦 🤰
懷孕	懷孕 🤰
大肚子	大肚子 🤰 🫃
懷了	懷了 🤰
孕肚	孕肚 🤰
男人懷孕	男人懷孕 🫃
懷孕的男人	懷孕的男人 🫃
啤酒肚	啤酒肚 🫃
將軍肚	將軍肚 🫃
哺乳	哺乳 🤱 👩‍🍼
母乳	母乳 🤱
母乳餵養	母乳餵養 🤱
餵奶	餵奶 🤱
哺乳的女人	哺乳的女人 👩‍🍼
奶媽	奶媽 👩‍🍼
哺乳的男人	哺乳的男人 👨‍🍼
奶爸	奶爸 👨‍🍼
天使寶寶	天使寶寶 👼
小天使	小天使 👼
天使	天使 👼
聖誕老人	聖誕老人 🎅
聖誕夫人	聖誕夫人 🤶
聖誕奶奶	聖誕奶奶 🤶
超人	超人 🦸‍♂️ 🦸‍♀️
超級英雄	超級英雄 🦸‍♂️ 🦸‍♀️
男超人	男超人 🦸‍♂️
男超級英雄	男超級英雄 🦸‍♂️
女超人	女超人 🦸‍♀️
女超級英雄	女超級英雄 🦸‍♀️
反派	反派 🦹‍♂️ 🦹‍♀️
壞蛋	壞蛋 🦹‍♂️ 🦹‍♀️
超級大反派	超級大反派 🦹‍♂️ 🦹‍♀️
大反派	大反派 🦹‍♂️ 🦹‍♀️
男反派	男反派 🦹‍♂️
男壞蛋	男壞蛋 🦹‍♂️
男超級大反派	男超級大反派 🦹‍♂️
男大反派	男大反派 🦹‍♂️
女反派	女反派 🦹‍♀️
女壞蛋	女壞蛋 🦹‍♀️
女超級大反派	女超級大反派 🦹‍♀️
女大反派	女大反派 🦹‍♀️
法師	法師 🧙‍♂️ 🧙‍♀️
魔法師	魔法師 🧙‍♂️ 🧙‍♀️
魔術師	魔術師 🧙‍♂️ 🧙‍♀️
男法師	男法師 🧙‍♂️
男魔法師	男魔法師 🧙‍♂️
男魔術師	男魔術師 🧙‍♂️
男巫	男巫 🧙‍♂️
女法師	女法師 🧙‍♀️
女魔法師	女魔法師 🧙‍♀️
女魔術師	女魔術師 🧙‍♀️
女巫	女巫 🧙‍♀️
妖精	妖精 🧚‍♂️ 🧚‍♀️
小精靈	小精靈 🧚‍♂️ 🧚‍♀️
小仙子	小仙子 🧚‍♂️ 🧚‍♀️
小仙女	小仙女 🧚‍♀️
吸血鬼	吸血鬼 🧛‍♂️ 🧛‍♀️
德古拉	德古拉 🧛‍♂️ 🧛‍♀️
男吸血鬼	男吸血鬼 🧛‍♂️
女吸血鬼	女吸血鬼 🧛‍♀️
人魚	人魚 🧜‍♂️ 🧜‍♀️
美男魚	美男魚 🧜‍♂️
男人魚	男人魚 🧜‍♂️
海王	海王 🧜‍♂️
美人魚	美人魚 🧜‍♀️
精靈	精靈 🧝‍♂️ 🧝‍♀️
男精靈	男精靈 🧝‍♂️
精靈族	精靈族 🧝‍♂️ 🧝‍♀️
女精靈	女精靈 🧝‍♀️
阿拉丁	阿拉丁 🧞‍♂️ 🧞‍♀️
阿拉丁神燈	阿拉丁神燈 🧞‍♂️ 🧞‍♀️
燈神	燈神 🧞‍♂️ 🧞‍♀️
男燈神	男燈神 🧞‍♂️
女燈神	女燈神 🧞‍♀️
殭屍	殭屍 🧟‍♂️ 🧟‍♀️
喪屍	喪屍 🧟‍♂️ 🧟‍♀️
行屍走肉	行屍走肉 🧟‍♂️ 🧟‍♀️
男殭屍	男殭屍 🧟‍♂️
男喪屍	男喪屍 🧟‍♂️
男行屍走肉	男行屍走肉 🧟‍♂️
女殭屍	女殭屍 🧟‍♀️
女喪屍	女喪屍 🧟‍♀️
女行屍走肉	女行屍走肉 🧟‍♀️
巨怪	巨怪 🧌
穴居巨怪	穴居巨怪 🧌
按摩	按摩 💆‍♂️ 💆‍♀️
美容	美容 💆‍♂️ 💆‍♀️
剪頭	剪頭 💇‍♂️ 💇‍♀️
剪髮	剪髮 💇‍♂️ 💇‍♀️
理髮	理髮 💇‍♂️ 💇‍♀️
理頭	理頭 💇‍♂️ 💇‍♀️
剪頭髮	剪頭髮 💇‍♂️ 💇‍♀️
理頭髮	理頭髮 💇‍♂️ 💇‍♀️
做造型	做造型 💇‍♂️ 💇‍♀️
美容美髮	美容美髮 💇‍♂️ 💇‍♀️
走路	走路 🚶‍♂️ 🚶‍♀️
徒步	徒步 🚶‍♂️ 🚶‍♀️
行走	行走 🚶‍♂️ 🚶‍♀️
站著	站著 🧍‍♂️ 🧍‍♀️
站立	站立 🧍‍♂️ 🧍‍♀️
站立者	站立者 🧍‍♂️ 🧍‍♀️
站立的男人	站立的男人 🧍‍♂️
哥哥	哥哥 🧍‍♂️
弟弟	弟弟 🧍‍♂️
男仔	男仔 🧍‍♂️
站立的女人	站立的女人 🧍‍♀️
姐姐	姐姐 🧍‍♀️
妹妹	妹妹 🧍‍♀️
女仔	女仔 🧍‍♀️
跪坐	跪坐 🧎‍♂️ 🧎‍♀️
拄盲杖的人	拄盲杖的人 👨‍🦯 👩‍🦯
拿著白手杖的人	拿著白手杖的人 👨‍🦯 👩‍🦯
坐電動輪椅的人	坐電動輪椅的人 👨‍🦼 👩‍🦼
坐電動輪椅的男人	坐電動輪椅的男人 👨‍🦼
電動輪椅	電動輪椅 👨‍🦼 👩‍🦼 🦼
坐電動輪椅的女人	坐電動輪椅的女人 👩‍🦼
坐手動輪椅的人	坐手動輪椅的人 👨‍🦽 👩‍🦽
坐手動輪椅的男人	坐手動輪椅的男人 👨‍🦽
手動輪椅	手動輪椅 👨‍🦽 👩‍🦽 🦽
坐手動輪椅的女人	坐手動輪椅的女人 👩‍🦽
跑步	跑步 🏃‍♂️ 🏃‍♀️
跑步者	跑步者 🏃‍♂️ 🏃‍♀️
馬拉松	馬拉松 🏃‍♂️ 🏃‍♀️
跳舞	跳舞 💃 🕺
跳舞的女人	跳舞的女人 💃
舞女	舞女 💃
跳舞的男人	跳舞的男人 🕺
舞者	舞者 🕺
浮在地面上的西裝男	浮在地面上的西裝男 🕴
兔先生	兔先生 👯‍♂️
兔耳朵	兔耳朵 👯‍♂️ 👯‍♀️
兔女郎	兔女郎 👯‍♀️
桑拿	桑拿 🧖‍♂️ 🧖‍♀️
蒸房	蒸房 🧖‍♂️ 🧖‍♀️
蒸桑拿	蒸桑拿 🧖‍♂️ 🧖‍♀️
蒸房裡的人	蒸房裡的人 🧖‍♂️ 🧖‍♀️
蒸房裡的男人	蒸房裡的男人 🧖‍♂️
蒸房裡的女人	蒸房裡的女人 🧖‍♀️
攀巖者	攀巖者 🧗‍♂️ 🧗‍♀️
攀爬的人	攀爬的人 🧗‍♂️ 🧗‍♀️
登山者	登山者 🧗‍♂️ 🧗‍♀️
登山	登山 🧗‍♂️ 🧗‍♀️
攀山	攀山 🧗‍♂️ 🧗‍♀️
攀爬的男人	攀爬的男人 🧗‍♂️
攀爬的女人	攀爬的女人 🧗‍♀️
擊劍者	擊劍者 🤺
擊劍	擊劍 🤺
擊劍選手	擊劍選手 🤺
劍鬥	劍鬥 🤺
賽馬	賽馬 🏇
騎馬	騎馬 🏇
賽馬騎師	賽馬騎師 🏇
滑雪	滑雪 ⛷️
滑雪的人	滑雪的人 ⛷️
單板滑雪	單板滑雪 🏂
滑雪板	滑雪板 🏂
高爾夫球手	高爾夫球手 🏌️‍♂️ 🏌️‍♀️
打高爾夫的人	打高爾夫的人 🏌️‍♂️ 🏌️‍♀️
高爾夫	高爾夫 🏌️‍♂️ 🏌️‍♀️ ⛳
打高爾夫	打高爾夫 🏌️‍♂️ 🏌️‍♀️
衝浪者	衝浪者 🏄‍♂️ 🏄‍♀️
衝浪	衝浪 🏄‍♂️ 🏄‍♀️
男生衝浪	男生衝浪 🏄‍♂️
女生衝浪	女生衝浪 🏄‍♀️
划船	划船 🚣‍♂️ 🚣‍♀️
划艇	划艇 🚣‍♂️ 🚣‍♀️
泛舟	泛舟 🚣‍♂️ 🚣‍♀️
游泳者	游泳者 🏊‍♂️ 🏊‍♀️
游泳	游泳 🏊‍♂️ 🏊‍♀️
泳客	泳客 🏊‍♂️ 🏊‍♀️
男生游泳	男生游泳 🏊‍♂️
女生游泳	女生游泳 🏊‍♀️
籃球運動員	籃球運動員 ⛹️‍♂️ ⛹️‍♀️
打籃球	打籃球 ⛹️‍♂️ ⛹️‍♀️
玩籃球	玩籃球 ⛹️‍♂️ ⛹️‍♀️
舉重	舉重 🏋️‍♂️ 🏋️‍♀️
舉重運動員	舉重運動員 🏋️‍♂️ 🏋️‍♀️
男生舉重	男生舉重 🏋️‍♂️
男舉重運動員	男舉重運動員 🏋️‍♂️
女生舉重	女生舉重 🏋️‍♀️
女舉重運動員	女舉重運動員 🏋️‍♀️
騎車	騎車 🚴‍♂️ 🚴‍♀️
騎單車	騎單車 🚴‍♂️ 🚴‍♀️
騎自行車	騎自行車 🚴‍♂️ 🚴‍♀️
山地車	山地車 🚵‍♂️ 🚵‍♀️
山地自行車	山地自行車 🚵‍♂️ 🚵‍♀️
騎山地車	騎山地車 🚵‍♂️ 🚵‍♀️
側手翻	側手翻 🤸‍♂️ 🤸‍♀️
翻筋斗	翻筋斗 🤸‍♂️ 🤸‍♀️
翻跟頭	翻跟頭 🤸‍♂️ 🤸‍♀️
摔跤	摔跤 🤼‍♂️ 🤼‍♀️
摔跤選手	摔跤選手 🤼‍♂️ 🤼‍♀️
格鬥	格鬥 🤼‍♂️ 🤼‍♀️
水球	水球 🤽‍♂️ 🤽‍♀️
玩水球	玩水球 🤽‍♂️ 🤽‍♀️
男生玩水球	男生玩水球 🤽‍♂️
女生玩水球	女生玩水球 🤽‍♀️
手球	手球 🤾‍♂️ 🤾‍♀️
玩手球	玩手球 🤾‍♂️ 🤾‍♀️
打手球	打手球 🤾‍♂️ 🤾‍♀️
雜耍	雜耍 🤹‍♂️ 🤹‍♀️
拋接	拋接 🤹‍♂️ 🤹‍♀️
拋接雜耍	拋接雜耍 🤹‍♂️ 🤹‍♀️
蓮花坐的人	蓮花坐的人 🧘‍♂️ 🧘‍♀️
蓮花坐	蓮花坐 🧘‍♂️ 🧘‍♀️
全蓮花坐	全蓮花坐 🧘‍♂️ 🧘‍♀️
冥想	冥想 🧘‍♂️ 🧘‍♀️
瑜伽	瑜伽 🧘‍♂️ 🧘‍♀️
盤腿	盤腿 🧘‍♂️ 🧘‍♀️
打坐	打坐 🧘‍♂️ 🧘‍♀️
瑜伽男	瑜伽男 🧘‍♂️
盤腿的男人	盤腿的男人 🧘‍♂️
瑜伽女	瑜伽女 🧘‍♀️
盤腿的女人	盤腿的女人 🧘‍♀️
洗澡	洗澡 🛀
洗澡的人	洗澡的人 🛀
泡澡	泡澡 🛀
泡澡的人	泡澡的人 🛀
睡覺的人	睡覺的人 🛌
躺在床上的人	躺在床上的人 🛌
床上休息	床上休息 🛌
牽手	牽手 🧑‍🤝‍🧑
手拉手	手拉手 🧑‍🤝‍🧑
兩個牽手的女人	兩個牽手的女人 👭
兩個女人	兩個女人 👭
閨蜜	閨蜜 👭
情侶	情侶 👫
牽手的情侶	牽手的情侶 👫
手拉手的情侶	手拉手的情侶 👫
兩個牽手的男人	兩個牽手的男人 👬
兩個男人	兩個男人 👬
兄弟	兄弟 👬
基友	基友 👬
好基友	好基友 👬
好兄弟	好兄弟 👬
戀愛	戀愛 👩‍❤️‍👨
談戀愛	談戀愛 👩‍❤️‍👨
相愛	相愛 👩‍❤️‍👨
男同	男同 👨‍❤️‍👨
男同性戀	男同性戀 👨‍❤️‍👨
同性戀	同性戀 👨‍❤️‍👨 👩‍❤️‍👩
玻璃	玻璃 👨‍❤️‍👨
女同	女同 👩‍❤️‍👩
女同性戀	女同性戀 👩‍❤️‍👩
拉拉	拉拉 👩‍❤️‍👩
一家人	一家人 👨‍👩‍👦 👨‍👩‍👧 👨‍👩‍👧‍👦 👨‍👩‍👦‍👦 👨‍👩‍👧‍👧
一家三口	一家三口 👨‍👩‍👦 👨‍👩‍👧
三口之家	三口之家 👨‍👩‍👦 👨‍👩‍👧
一家四口	一家四口 👨‍👩‍👧‍👦 👨‍👩‍👦‍👦 👨‍👩‍👧‍👧
四口之家	四口之家 👨‍👩‍👧‍👦 👨‍👩‍👦‍👦 👨‍👩‍👧‍👧
父子	父子 👨‍👦
父女	父女 👨‍👧
母子	母子 👩‍👦
母女	母女 👩‍👧
剪影	剪影 🗣 👤 👥 🫂
講話	講話 🗣
講話者	講話者 🗣
講話者的頭部剪影	講話者的頭部剪影 🗣
頭部剪影	頭部剪影 🗣
人物剪影	人物剪影 👤
半身像	半身像 👤 👥
頭像	頭像 👤
雙人像	雙人像 👥
雙人	雙人 👥
擁抱的人	擁抱的人 🫂
抱在一起	抱在一起 🫂
腳印	腳印 👣
足跡	足跡 👣
膚色	膚色 🏻 🏼 🏽 🏾 🏿
淺膚色	淺膚色 🏻
中等淺膚色	中等淺膚色 🏼
較淺膚色	較淺膚色 🏼
中等膚色	中等膚色 🏽
中等深膚色	中等深膚色 🏾
較深膚色	較深膚色 🏾
深膚色	深膚色 🏿
赤發	赤發 🦰
猴	猴 🐵 🐒
猴臉	猴臉 🐵
猴頭	猴頭 🐵
猴子	猴子 🐒
馬騮	馬騮 🐒
大猩猩	大猩猩 🦍
猩猩	猩猩 🦍 🦧
紅毛猩猩	紅毛猩猩 🦧
人猿	人猿 🦧
狗	狗 🐶 🐕
狗臉	狗臉 🐶
狗頭	狗頭 🐶
小狗	小狗 🐶 🐕
Doge	Doge 🐶
旺柴	旺柴 🐶
旺財	旺財 🐶
狗仔	狗仔 🐶
犬	犬 🐕
狗子	狗子 🐕
狗狗	狗狗 🐕
導盲犬	導盲犬 🦮
金毛	金毛 🦮
金毛犬	金毛犬 🦮
金毛尋回犬	金毛尋回犬 🦮
工作犬	工作犬 🐕‍🦺
服務犬	服務犬 🐕‍🦺
貴賓犬	貴賓犬 🐩
捲毛狗	捲毛狗 🐩
狼	狼 🐺
狼臉	狼臉 🐺
狼頭	狼頭 🐺
狐狸	狐狸 🦊
狐狸臉	狐狸臉 🦊
狐狸偷	狐狸偷 🦊
浣熊	浣熊 🦝
小浣熊	小浣熊 🦝
乾脆面	乾脆面 🦝
乾脆面君	乾脆面君 🦝
貓	貓 🐱
貓咪	貓咪 🐱 🐈
小貓咪	小貓咪 🐱 🐈
貓臉	貓臉 🐱
貓頭	貓頭 🐱
小貓	小貓 🐱 🐈
喵	喵 🐱
喵喵	喵喵 🐱
喵喵喵	喵喵喵 🐱
喵喵叫	喵喵叫 🐱
橘貓	橘貓 🐈
黑貓	黑貓 🐈‍⬛
小黑貓	小黑貓 🐈‍⬛
獅	獅 🦁
獅子	獅子 🦁
獅臉	獅臉 🦁
獅頭	獅頭 🦁
獅子臉	獅子臉 🦁
獅子頭	獅子頭 🦁
虎	虎 🐯
虎臉	虎臉 🐯
虎頭	虎頭 🐯
老虎	老虎 🐯 🐅
老虎臉	老虎臉 🐯
老虎頭	老虎頭 🐯
獵豹	獵豹 🐆
豹	豹 🐆
豹子	豹子 🐆
馬	馬 🐴 🐎
馬兒	馬兒 🐴 🐎
馬臉	馬臉 🐴
馬頭	馬頭 🐴
駝鹿	駝鹿 🫎
駝鹿臉	駝鹿臉 🫎
駝鹿頭	駝鹿頭 🫎
鹿角	鹿角 🫎
馬鹿	馬鹿 🫎
驢	驢 🫏
小驢	小驢 🫏
驢兒	驢兒 🫏
小馬	小馬 🐎
駿馬	駿馬 🐎
獨角獸	獨角獸 🦄
獨角獸臉	獨角獸臉 🦄
獨角獸頭	獨角獸頭 🦄
斑馬	斑馬 🦓
鹿	鹿 🦌
麋鹿	麋鹿 🦌
大野牛	大野牛 🦬
野牛	野牛 🦬
牛	牛 🐮
牛臉	牛臉 🐮
牛頭	牛頭 🐮
牛牛	牛牛 🐮
小牛	小牛 🐮
公牛	公牛 🐂
水牛	水牛 🐃
奶牛	奶牛 🐄
豬	豬 🐷 🐖
豬豬	豬豬 🐷 🐖
豬臉	豬臉 🐷
豬頭	豬頭 🐷
懶豬	懶豬 🐷
小豬	小豬 🐷
野豬	野豬 🐗
豬鼻子	豬鼻子 🐽
豬鼻	豬鼻 🐽
公羊	公羊 🐏
綿羊	綿羊 🐑
羊	羊 🐑
羊羊	羊羊 🐑
小羊	小羊 🐑
山羊	山羊 🐐
駱駝	駱駝 🐪 🐫
單峰駱駝	單峰駱駝 🐪
雙峰駱駝	雙峰駱駝 🐫
羊駝	羊駝 🦙
草泥馬	草泥馬 🦙
長頸鹿	長頸鹿 🦒
麒麟鹿	麒麟鹿 🦒
大象	大象 🐘
猛獁象	猛獁象 🦣
犀牛	犀牛 🦏
河馬	河馬 🦛
老鼠	老鼠 🐭 🐀
耗子	耗子 🐭 🐀
鼠臉	鼠臉 🐭
鼠	鼠 🐭
老鼠臉	老鼠臉 🐭
鼠頭	鼠頭 🐭
老鼠頭	老鼠頭 🐭
白鼠	白鼠 🐁
小白鼠	小白鼠 🐁
小老鼠	小老鼠 🐁
倉鼠	倉鼠 🐹
倉鼠臉	倉鼠臉 🐹
倉鼠頭	倉鼠頭 🐹
兔	兔 🐰
兔子	兔子 🐰 🐇
兔臉	兔臉 🐰
兔子臉	兔子臉 🐰
兔頭	兔頭 🐰
兔子頭	兔子頭 🐰
小兔子	小兔子 🐇
小白兔	小白兔 🐇
大白兔	大白兔 🐇
松鼠	松鼠 🐿
花栗鼠	花栗鼠 🐿
河狸	河狸 🦫
海狸	海狸 🦫
刺蝟	刺蝟 🦔
蝙蝠	蝙蝠 🦇
蟙䘃	蟙䘃 🦇
熊	熊 🐻
熊臉	熊臉 🐻
熊頭	熊頭 🐻
小熊	小熊 🐻
北極熊	北極熊 🐻‍❄️
北極熊臉	北極熊臉 🐻‍❄️
北極熊頭	北極熊頭 🐻‍❄️
考拉	考拉 🐨
樹袋熊	樹袋熊 🐨
無尾熊	無尾熊 🐨
熊貓	熊貓 🐼
大熊貓	大熊貓 🐼
貓熊	貓熊 🐼
胖達	胖達 🐼
國寶	國寶 🐼
熊貓臉	熊貓臉 🐼
熊貓頭	熊貓頭 🐼
熊貓人	熊貓人 🐼
panda	panda 🐼
樹懶	樹懶 🦥
樹懶先生	樹懶先生 🦥
慢吞吞	慢吞吞 🦥
水獺	水獺 🦦
海獺	海獺 🦦
鼬	鼬 🦨
臭鼬	臭鼬 🦨
袋鼠	袋鼠 🦘
獾	獾 🦡
蜜獾	蜜獾 🦡
掌印	掌印 🐾
爪印	爪印 🐾
動物腳印	動物腳印 🐾
火雞	火雞 🦃
雞	雞 🐔
雞頭	雞頭 🐔
雞巴	雞巴 🐔
公雞	公雞 🐓
母雞	母雞 🐓
大公雞	大公雞 🐓
大母雞	大母雞 🐓
孵化小雞	孵化小雞 🐣
小雞	小雞 🐣 🐤 🐥
小雞破殼	小雞破殼 🐣
破殼	破殼 🐣
出生	出生 🐣
小雞頭	小雞頭 🐤
小雞雞	小雞雞 🐥
鳥	鳥 🐦
鳥頭	鳥頭 🐦
小鳥	小鳥 🐦
企鵝	企鵝 🐧
企鵝頭	企鵝頭 🐧
鴿子	鴿子 🕊
和平象徵	和平象徵 🕊
和平的象徵	和平的象徵 🕊
老鷹	老鷹 🦅
鷹	鷹 🦅
鴨	鴨 🦆
鴨子	鴨子 🦆
小鴨子	小鴨子 🦆
嘎嘎	嘎嘎 🦆
天鵝	天鵝 🦢
白天鵝	白天鵝 🦢
醜小鴨	醜小鴨 🦢
貓頭鷹	貓頭鷹 🦉
鴞	鴞 🦉
渡渡鳥	渡渡鳥 🦤
羽毛	羽毛 🪶
火烈鳥	火烈鳥 🦩
孔雀	孔雀 🦚
鸚鵡	鸚鵡 🦜
翅膀	翅膀 🪽
天使的翅膀	天使的翅膀 🪽
羽翼	羽翼 🪽
黑鳥	黑鳥 🐦‍⬛
烏鴉	烏鴉 🐦‍⬛
黑色小鳥	黑色小鳥 🐦‍⬛
鵝	鵝 🪿
大鵝	大鵝 🪿
鵝鵝鵝	鵝鵝鵝 🪿
青蛙	青蛙 🐸
青蛙頭	青蛙頭 🐸
青蛙臉	青蛙臉 🐸
蛤蟆	蛤蟆 🐸
蛤蛤	蛤蛤 🐸
蛤	蛤 🐸
鱷魚	鱷魚 🐊
烏龜	烏龜 🐢
海龜	海龜 🐢
龜	龜 🐢
蜥蜴	蜥蜴 🦎
壁虎	壁虎 🦎
蛇	蛇 🐍
蛇蛇	蛇蛇 🐍
小蛇	小蛇 🐍
一條蛇	一條蛇 🐍
Python	Python 🐍
龍	龍 🐲 🐉
龍頭	龍頭 🐲
龍王	龍王 🐲
中國龍	中國龍 🐲
神龍	神龍 🐉
巨龍	巨龍 🐉
一條龍	一條龍 🐉
恐龍	恐龍 🦕 🦖
腕龍	腕龍 🦕
雷龍	雷龍 🦕
樑龍	樑龍 🦕
霸王龍	霸王龍 🦖
暴龍	暴龍 🦖
噴水的鯨魚	噴水的鯨魚 🐳
噴水的鯨	噴水的鯨 🐳
噴水	噴水 🐳
鯨魚	鯨魚 🐳 🐋
海豚	海豚 🐬
海豹	海豹 🦭
海獅	海獅 🦭
魚	魚 🐟
魚兒	魚兒 🐟
小魚	小魚 🐟
小魚兒	小魚兒 🐟
熱帶魚	熱帶魚 🐠
河豚	河豚 🐡
鯊魚	鯊魚 🦈
大白鯊	大白鯊 🦈
白鯊	白鯊 🦈
章魚	章魚 🐙
海螺	海螺 🐚
貝殼	貝殼 🐚
珊瑚	珊瑚 🪸
珊瑚礁	珊瑚礁 🪸
水母	水母 🪼
海蜇	海蜇 🪼
蝸牛	蝸牛 🐌
蝴蝶	蝴蝶 🦋
鳳尾蝶	鳳尾蝶 🦋
蟲子	蟲子 🐛
毛毛蟲	毛毛蟲 🐛
毛蟲	毛蟲 🐛
bug	bug 🐛
螞蟻	螞蟻 🐜
蜜蜂	蜜蜂 🐝
小蜜蜂	小蜜蜂 🐝
昆蟲	昆蟲 🪲
甲蟲	甲蟲 🪲
聖甲蟲	聖甲蟲 🪲
瓢蟲	瓢蟲 🐞
七星瓢蟲	七星瓢蟲 🐞
蛐蛐	蛐蛐 🦗
蟋蟀	蟋蟀 🦗
蚱蜢	蚱蜢 🦗
蟑螂	蟑螂 🪳
小強	小強 🪳
蜘蛛	蜘蛛 🕷
蛛網	蛛網 🕸
蜘蛛網	蜘蛛網 🕸
蠍子	蠍子 🦂
蚊蠅	蚊蠅 🦟 🪰
蚊子	蚊子 🦟
蚊虻	蚊虻 🦟
蒼蠅	蒼蠅 🪰
家蠅	家蠅 🪰
蠕蟲	蠕蟲 🪱
寄生蟲	寄生蟲 🪱
蚯蚓	蚯蚓 🪱
微生物	微生物 🦠
變形蟲	變形蟲 🦠
病毒	病毒 🦠
細菌	細菌 🦠
花束	花束 💐
鮮花	鮮花 💐
捧花	捧花 💐
櫻花	櫻花 🌸
白色的花	白色的花 💮
白花	白花 💮
蓮花	蓮花 🪷
花結	花結 🏵
玫瑰花結	玫瑰花結 🏵
玫瑰	玫瑰 🌹
玫瑰花	玫瑰花 🌹
紅玫瑰	紅玫瑰 🌹
枯萎的玫瑰	枯萎的玫瑰 🥀
枯萎的花	枯萎的花 🥀
枯萎	枯萎 🥀
凋謝	凋謝 🥀
芙蓉	芙蓉 🌺
芙蓉花	芙蓉花 🌺
木槿	木槿 🌺
木槿花	木槿花 🌺
向日葵	向日葵 🌻
太陽花	太陽花 🌻
向陽花	向陽花 🌻
追日花	追日花 🌻
逐日花	逐日花 🌻
花朵	花朵 🌼
開花	開花 🌼
開花了	開花了 🌼
波斯菊	波斯菊 🌼
雛菊	雛菊 🌼
花	花 🌷
鬱金香	鬱金香 🌷
風信子	風信子 🪻
幼苗	幼苗 🌱
嫩苗	嫩苗 🌱
發芽	發芽 🌱
盆栽	盆栽 🪴
盆栽植物	盆栽植物 🪴
花盆	花盆 🪴
常青樹	常青樹 🌲
松樹	松樹 🌲
樹	樹 🌳
樹木	樹木 🌳
大樹	大樹 🌳
落葉樹	落葉樹 🌳
棕櫚	棕櫚 🌴
棕櫚樹	棕櫚樹 🌴
仙人掌	仙人掌 🌵
稻穗	稻穗 🌾
水稻	水稻 🌾
草本植物	草本植物 🌿
草藥	草藥 🌿
藥草	藥草 🌿
香草	香草 🌿
中藥	中藥 🌿
三葉草	三葉草 ☘
四葉草	四葉草 🍀
幸運草	幸運草 🍀
楓葉	楓葉 🍁
楓樹葉	楓樹葉 🍁
落葉	落葉 🍂
葉子	葉子 🍃
樹葉	樹葉 🍃
空鳥巢	空鳥巢 🪹
空巢	空巢 🪹
有蛋的鳥巢	有蛋的鳥巢 🪺
有蛋的巢	有蛋的巢 🪺
鳥巢	鳥巢 🪺
蘑菇	蘑菇 🍄
小蘑菇	小蘑菇 🍄
葡萄	葡萄 🍇
提子	提子 🍇
甜瓜	甜瓜 🍈
哈密瓜	哈密瓜 🍈
新疆瓜	新疆瓜 🍈
西瓜	西瓜 🍉
吃瓜	吃瓜 🍉
柑橘	柑橘 🍊
橘子	橘子 🍊
蜜橘	蜜橘 🍊
檸檬	檸檬 🍋
香蕉	香蕉 🍌
菠蘿	菠蘿 🍍
鳳梨	鳳梨 🍍
芒果	芒果 🥭
蘋果	蘋果 🍎 🍏
小蘋果	小蘋果 🍎 🍏
紅蘋果	紅蘋果 🍎
青蘋果	青蘋果 🍏
綠蘋果	綠蘋果 🍏
梨	梨 🍐
梨子	梨子 🍐
桃	桃 🍑
桃子	桃子 🍑
仙桃	仙桃 🍑
櫻桃	櫻桃 🍒
草莓	草莓 🍓
藍莓	藍莓 🫐
奇異果	奇異果 🥝
獼猴桃	獼猴桃 🥝
西紅柿	西紅柿 🍅
番茄	番茄 🍅
橄欖	橄欖 🫒
黃欖	黃欖 🫒
青橄欖	青橄欖 🫒
椰子	椰子 🥥
椰子果	椰子果 🥥
牛油果	牛油果 🥑
鱷梨	鱷梨 🥑
茄子	茄子 🍆
土豆	土豆 🥔
洋芋	洋芋 🥔
馬鈴薯	馬鈴薯 🥔
胡蘿蔔	胡蘿蔔 🥕
蘿蔔	蘿蔔 🥕
紅蘿蔔	紅蘿蔔 🥕
玉米	玉米 🌽
苞米	苞米 🌽
紅辣椒	紅辣椒 🌶
辣椒	辣椒 🌶
甜椒	甜椒 🫑
菜椒	菜椒 🫑
彩椒	彩椒 🫑
燈籠椒	燈籠椒 🫑
黃瓜	黃瓜 🥒
青瓜	青瓜 🥒
綠葉蔬菜	綠葉蔬菜 🥬
圓白菜	圓白菜 🥬
小白菜	小白菜 🥬
白菜	白菜 🥬
蔬菜	蔬菜 🥬
西蘭花	西蘭花 🥦
花椰菜	花椰菜 🥦
綠菜花	綠菜花 🥦
青花菜	青花菜 🥦
綠花椰菜	綠花椰菜 🥦
蒜	蒜 🧄
大蒜	大蒜 🧄
蒜香	蒜香 🧄
洋蔥	洋蔥 🧅
蔥頭	蔥頭 🧅
洋蒜	洋蒜 🧅
皮芽子	皮芽子 🧅
花生	花生 🥜
落花生	落花生 🥜
豆	豆 🫘
豆子	豆子 🫘
豆類	豆類 🫘
栗子	栗子 🌰
榛子	榛子 🌰
姜	姜 🫚
豌豆	豌豆 🫛
豆莢	豆莢 🫛
豌豆莢	豌豆莢 🫛
麵包	麵包 🍞
牛角麵包	牛角麵包 🥐
新月形麵包	新月形麵包 🥐
羊角麵包	羊角麵包 🥐
法式長棍麵包	法式長棍麵包 🥖
長棍麵包	長棍麵包 🥖
長麵包	長麵包 🥖
麵餅	麵餅 🫓
大餅	大餅 🫓
餅	餅 🫓
椒鹽捲餅	椒鹽捲餅 🥨
百吉餅	百吉餅 🥯
百吉圈	百吉圈 🥯
麵包圈	麵包圈 🥯
烘焙	烘焙 🥯
煎餅	煎餅 🥞 🌯
薄煎餅	薄煎餅 🥞
烙餅	烙餅 🥞
蛋餅	蛋餅 🥞
華夫餅	華夫餅 🧇
格子餅	格子餅 🧇
奶酪	奶酪 🧀
芝士	芝士 🧀
起司	起司 🧀
肉	肉 🍖 🥩
肉肉	肉肉 🍖 🥩
帶骨肉	帶骨肉 🍖
排骨	排骨 🍖
吃肉	吃肉 🍖
家禽腿	家禽腿 🍗
家禽的腿	家禽的腿 🍗
雞腿	雞腿 🍗
雞腿兒	雞腿兒 🍗
肉排	肉排 🥩
牛排	牛排 🥩
豬排	豬排 🥩
羊排	羊排 🥩
培根	培根 🥓
煙肉	煙肉 🥓
漢堡	漢堡 🍔
漢堡包	漢堡包 🍔
薯條	薯條 🍟
比薩	比薩 🍕
比薩餅	比薩餅 🍕
吃比薩	吃比薩 🍕
吃比薩餅	吃比薩餅 🍕
熱狗	熱狗 🌭
三明治	三明治 🥪
捲餅	捲餅 🌮 🌯
墨西哥捲餅	墨西哥捲餅 🌮 🌯
墨西哥薄餅卷	墨西哥薄餅卷 🌮
煎餅餜子	煎餅餜子 🌯
墨西哥粽	墨西哥粽 🫔
墨西哥粽子	墨西哥粽子 🫔
皮塔三明治	皮塔三明治 🥙
法拉費	法拉費 🧆
中東蔬菜球	中東蔬菜球 🧆
油炸鷹嘴豆餅	油炸鷹嘴豆餅 🧆
炸豆丸子	炸豆丸子 🧆
肉丸	肉丸 🧆
肉丸子	肉丸子 🧆
雞蛋	雞蛋 🥚
蛋	蛋 🥚
蛋蛋	蛋蛋 🥚
烹飪	烹飪 🍳
平底鍋	平底鍋 🍳
煎蛋	煎蛋 🍳
食物	食物 🥘 🍲
一鍋食物	一鍋食物 🥘 🍲
火鍋	火鍋 🥘 🍲
奶酪火鍋	奶酪火鍋 🫕
芝士火鍋	芝士火鍋 🫕
起司火鍋	起司火鍋 🫕
碗勺	碗勺 🥣
放著勺的碗	放著勺的碗 🥣
碗	碗 🥣
湯	湯 🥣
湯碗	湯碗 🥣
沙拉	沙拉 🥗
綠色沙拉	綠色沙拉 🥗
蔬菜沙拉	蔬菜沙拉 🥗
爆米花	爆米花 🍿
黃油	黃油 🧈
黃乳油	黃乳油 🧈
鹽	鹽 🧂
食鹽	食鹽 🧂
佐料瓶	佐料瓶 🧂
佐料	佐料 🧂
調味品	調味品 🧂
罐頭	罐頭 🥫
罐頭食品	罐頭食品 🥫
便當	便當 🍱
便當盒	便當盒 🍱
盒飯	盒飯 🍱
外賣	外賣 🍱 🥡
快餐	快餐 🍱
快餐盒	快餐盒 🍱
米餅	米餅 🍘
米果	米果 🍘
飯糰	飯糰 🍙
煮熟的飯	煮熟的飯 🍚
米飯	米飯 🍚
大米	大米 🍚
大米飯	大米飯 🍚
咖喱	咖喱 🍛
咖喱飯	咖喱飯 🍛
冒熱氣的碗	冒熱氣的碗 🍜
拉麵	拉麵 🍜
麵條	麵條 🍜
碗麵	碗麵 🍜
一碗麵	一碗麵 🍜
吃麵	吃麵 🍜
意大利麵	意大利麵 🍝
意大利麵條	意大利麵條 🍝
意粉	意粉 🍝
意麵	意麵 🍝
地瓜	地瓜 🍠
烤地瓜	烤地瓜 🍠
紅薯	紅薯 🍠
烤紅薯	烤紅薯 🍠
番薯	番薯 🍠
烤番薯	烤番薯 🍠
甘薯	甘薯 🍠
烤甘薯	烤甘薯 🍠
關東煮	關東煮 🍢
串串	串串 🍢
壽司	壽司 🍣
炸蝦	炸蝦 🍤
天婦羅	天婦羅 🍤
盤繞是炸魚餅	盤繞是炸魚餅 🍥
魚餅	魚餅 🍥
魚板	魚板 🍥
月餅	月餅 🥮
月團	月團 🥮
豐收餅	豐收餅 🥮
團圓餅	團圓餅 🥮
糰子	糰子 🍡
糯米糰	糯米糰 🍡
餃子	餃子 🥟
水餃	水餃 🥟
幸運餅乾	幸運餅乾 🥠
外賣盒	外賣盒 🥡
外賣包裝	外賣包裝 🥡
外賣桶	外賣桶 🥡
螃蟹	螃蟹 🦀
蟹	蟹 🦀
蟹老闆	蟹老闆 🦀
龍蝦	龍蝦 🦞
小龍蝦	小龍蝦 🦞
麻辣小龍蝦	麻辣小龍蝦 🦞
蝦	蝦 🦐
大蝦	大蝦 🦐
對蝦	對蝦 🦐
魷魚	魷魚 🦑
烏賊	烏賊 🦑
墨魚	墨魚 🦑
牡蠣	牡蠣 🦪
生蠔	生蠔 🦪
蠔蠣	蠔蠣 🦪
軟冰淇淋	軟冰淇淋 🍦
軟冰激凌	軟冰激凌 🍦
冰淇淋	冰淇淋 🍦 🍨
冰激凌	冰激凌 🍦 🍨
圓筒冰淇淋	圓筒冰淇淋 🍦
圓筒冰激凌	圓筒冰激凌 🍦
甜筒	甜筒 🍦
刨冰	刨冰 🍧
冰沙	冰沙 🍧
油炸面圈	油炸面圈 🍩
甜甜圈	甜甜圈 🍩
曲奇	曲奇 🍪
餅乾	餅乾 🍪
曲奇餅乾	曲奇餅乾 🍪
cookie	cookie 🍪
cookies	cookies 🍪
蛋糕	蛋糕 🎂 🍰
生日蛋糕	生日蛋糕 🎂
水果蛋糕	水果蛋糕 🍰
紙杯蛋糕	紙杯蛋糕 🧁
派	派 🥧
油酥點心	油酥點心 🥧
點心	點心 🥧
巧克力	巧克力 🍫
巧克力棒	巧克力棒 🍫
朱古力	朱古力 🍫
朱古力棒	朱古力棒 🍫
糖果	糖果 🍬
糖	糖 🍬
吃糖	吃糖 🍬
棒棒糖	棒棒糖 🍭
蛋奶糕	蛋奶糕 🍮
甜品	甜品 🍮
甜點	甜點 🍮
布丁	布丁 🍮
蜜罐	蜜罐 🍯
蜂蜜	蜂蜜 🍯
奶瓶	奶瓶 🍼
喝奶	喝奶 🍼
一杯奶	一杯奶 🥛
牛奶杯	牛奶杯 🥛
牛奶	牛奶 🥛
杯子	杯子 🥛
咖啡	咖啡 ☕
咖啡杯	咖啡杯 ☕
喝咖啡	喝咖啡 ☕
茶壺	茶壺 🫖
一壺茶	一壺茶 🫖
一壺	一壺 🫖
茶	茶 🍵
茶水	茶水 🍵
茶杯	茶杯 🍵
喝茶	喝茶 🍵
泡茶	泡茶 🍵
清酒	清酒 🍶
開香檳	開香檳 🍾
香檳	香檳 🍾
葡萄酒	葡萄酒 🍷
酒杯	酒杯 🍷
酒	酒 🍷
雞尾酒	雞尾酒 🍸
熱帶飲料	熱帶飲料 🍹
熱帶水果飲料	熱帶水果飲料 🍹
水果飲料	水果飲料 🍹
果飲	果飲 🍹
冷飲	冷飲 🍹
啤酒	啤酒 🍺
乾杯	乾杯 🍻 🥂
碰杯	碰杯 🍻 🥂
威士忌	威士忌 🥃
平底杯	平底杯 🥃
一杯酒	一杯酒 🥃
一杯	一杯 🥃
玻璃杯	玻璃杯 🥃
烈酒	烈酒 🥃
傾倒液體	傾倒液體 🫗
傾倒	傾倒 🫗
外帶杯子	外帶杯子 🥤
帶吸管杯	帶吸管杯 🥤
吸管杯	吸管杯 🥤
飲料	飲料 🥤
波霸奶茶	波霸奶茶 🧋
珍珠奶茶	珍珠奶茶 🧋
奶茶	奶茶 🧋
一杯奶茶	一杯奶茶 🧋
果汁盒	果汁盒 🧃
果汁	果汁 🧃
馬黛茶	馬黛茶 🧉
冰塊	冰塊 🧊
冰	冰 🧊
加冰	加冰 🧊
筷子	筷子 🥢
餐具	餐具 🍽
刀叉	刀叉 🍴
勺子	勺子 🥄
湯勺	湯勺 🥄
匙子	匙子 🥄
湯匙	湯匙 🥄
刀	刀 🔪
菜刀	菜刀 🔪
水果刀	水果刀 🔪
小刀	小刀 🔪
罐子	罐子 🫙
瓶子	瓶子 🫙
玻璃瓶	玻璃瓶 🫙
雙耳瓶	雙耳瓶 🏺
地球	地球 🌐 🌍 🌎 🌏
子午線	子午線 🌐
經緯線	經緯線 🌐
地球儀	地球儀 🌍 🌎 🌏
歐洲	歐洲 🌍
非洲	非洲 🌍
歐洲非洲	歐洲非洲 🌍
非洲歐洲	非洲歐洲 🌍
歐洲地球儀	歐洲地球儀 🌍
非洲地球儀	非洲地球儀 🌍
歐洲非洲地球儀	歐洲非洲地球儀 🌍
歐非地球儀	歐非地球儀 🌍
美洲	美洲 🌎
美洲地球儀	美洲地球儀 🌎
亞洲	亞洲 🌏
澳洲	澳洲 🌏 🇦🇺
亞洲澳洲	亞洲澳洲 🌏
澳洲亞洲	澳洲亞洲 🌏
亞洲地球儀	亞洲地球儀 🌏
澳洲地球儀	澳洲地球儀 🌏
亞澳地球儀	亞澳地球儀 🌏
澳亞地球儀	澳亞地球儀 🌏
世界地圖	世界地圖 🗺
日本剪影	日本剪影 🗾
日本地圖	日本地圖 🗾
指南針	指南針 🧭
指北針	指北針 🧭
方向	方向 🧭
羅盤	羅盤 🧭
雪山	雪山 🏔
高山	高山 🏔
山	山 ⛰️
山脈	山脈 ⛰️
山峰	山峰 ⛰️
山頂	山頂 ⛰️
火山	火山 🌋
火山噴發	火山噴發 🌋
火山爆發	火山爆發 🌋
富士山	富士山 🗻
露營	露營 🏕
野營	野營 🏕
太陽傘	太陽傘 🏖
沙灘傘	沙灘傘 🏖 ⛱️
度假	度假 🏖
沙漠	沙漠 🏜
荒漠	荒漠 🏜
荒島	荒島 🏝
無人島	無人島 🏝
無人荒島	無人荒島 🏝
國家公園	國家公園 🏞
體育場	體育場 🏟
體育館	體育館 🏟
足球場	足球場 🏟
古典建築	古典建築 🏛
古建築	古建築 🏛
博物館	博物館 🏛
建築施工	建築施工 🏗
施工	施工 🏗 🚧
起重機	起重機 🏗
磚塊	磚塊 🧱
板磚	板磚 🧱
板兒磚	板兒磚 🧱
磚頭	磚頭 🧱
岩石	岩石 🪨
石頭	石頭 🪨
木頭	木頭 🪵
原木	原木 🪵
木材	木材 🪵
小屋	小屋 🛖
蒙古包	蒙古包 🛖
草屋	草屋 🛖
房屋群	房屋群 🏘
居民區	居民區 🏘
廢棄的房屋	廢棄的房屋 🏚
荒宅	荒宅 🏚
危樓	危樓 🏚
家	家 🏠
住宅樓	住宅樓 🏠
房子	房子 🏠
房屋	房屋 🏠
帶花園的樓房	帶花園的樓房 🏡
別墅	別墅 🏡
辦公樓	辦公樓 🏢
寫字樓	寫字樓 🏢
日本郵局	日本郵局 🏣
郵局	郵局 🏣 🏤
歐洲郵局	歐洲郵局 🏤
醫院	醫院 🏥
銀行	銀行 🏦
酒店	酒店 🏨
旅店	旅店 🏨
旅館	旅館 🏨
賓館	賓館 🏨
愛情酒店	愛情酒店 🏩
愛情旅店	愛情旅店 🏩
愛情旅館	愛情旅館 🏩
愛情賓館	愛情賓館 🏩
情侶酒店	情侶酒店 🏩
情侶旅店	情侶旅店 🏩
情侶旅館	情侶旅館 🏩
情侶賓館	情侶賓館 🏩
情人酒店	情人酒店 🏩
情人旅店	情人旅店 🏩
情人旅館	情人旅館 🏩
情人賓館	情人賓館 🏩
便利商店	便利商店 🏪
便利店	便利店 🏪
商店	商店 🏪
小商店	小商店 🏪
學校	學校 🏫
教學樓	教學樓 🏫
百貨商店	百貨商店 🏬
商場	商場 🏬
超市	超市 🏬
商超	商超 🏬
工廠	工廠 🏭
日本城堡	日本城堡 🏯
日式城堡	日式城堡 🏯
城堡	城堡 🏯 🏰
歐洲城堡	歐洲城堡 🏰
歐式城堡	歐式城堡 🏰
婚禮	婚禮 💒
教堂	教堂 💒 ⛪
東京塔	東京塔 🗼
自由女神像	自由女神像 🗽
自由女神	自由女神 🗽
聖堂	聖堂 ⛪
清真寺	清真寺 🕌
清真	清真 🕌
印度廟	印度廟 🛕
印度寺廟	印度寺廟 🛕
佛寺	佛寺 🛕
廟宇	廟宇 🛕
猶太教會堂	猶太教會堂 🕍
猶太教堂	猶太教堂 🕍
神社	神社 ⛩
日本神社	日本神社 ⛩
克爾白	克爾白 🕋
噴泉	噴泉 ⛲
公園	公園 ⛲
帳篷	帳篷 ⛺
霧氣籠罩的橋	霧氣籠罩的橋 🌁
霧濛濛	霧濛濛 🌁
霧氣	霧氣 🌁
霧都	霧都 🌁
星光閃閃的夜晚	星光閃閃的夜晚 🌃
夜晚	夜晚 🌃
晚上	晚上 🌃
半夜	半夜 🌃
深夜	深夜 🌃
城市景觀	城市景觀 🏙
城市風光	城市風光 🏙
都市景觀	都市景觀 🏙
都市風光	都市風光 🏙
城市	城市 🏙
都市	都市 🏙
大山日出	大山日出 🌄
山頂日出	山頂日出 🌄
山中日出	山中日出 🌄
日出	日出 🌄 🌅
旭日	旭日 🌄 🌅
旭日東昇	旭日東昇 🌄 🌅
暮色中的城市	暮色中的城市 🌆
暮色	暮色 🌆
黃昏	黃昏 🌆
傍晚	傍晚 🌆
大廈夕陽	大廈夕陽 🌇
夕陽	夕陽 🌇
日落	日落 🌇
落日	落日 🌇
橋	橋 🌉
夜間的大橋	夜間的大橋 🌉
夜間大橋	夜間大橋 🌉
夜幕下的橋	夜幕下的橋 🌉
大橋	大橋 🌉
溫泉	溫泉 ♨️
休息	休息 ♨️
旋轉木馬	旋轉木馬 🎠
遊樂園	遊樂園 🎠
滑梯	滑梯 🛝
滑滑梯	滑滑梯 🛝
摩天輪	摩天輪 🎡
過山車	過山車 🎢
理髮店招牌	理髮店招牌 💈
理髮店	理髮店 💈
馬戲	馬戲 🎪
馬戲團	馬戲團 🎪
馬戲團帳篷	馬戲團帳篷 🎪
蒸汽火車	蒸汽火車 🚂
軌道車	軌道車 🚃
動車	動車 🚄 🚅
新幹線	新幹線 🚄 🚅
列車	列車 🚄 🚅
高速列車	高速列車 🚄 🚅
高鐵	高鐵 🚄 🚅
高速子彈頭列車	高速子彈頭列車 🚅
子彈頭高速列車	子彈頭高速列車 🚅
火車	火車 🚆
綠皮火車	綠皮火車 🚆
地鐵	地鐵 🚇 Ⓜ️
地下鐵路	地下鐵路 🚇
輕軌電車	輕軌電車 🚈
輕軌	輕軌 🚈
車站	車站 🚉
火車站	火車站 🚉
站臺	站臺 🚉
單軌鐵路	單軌鐵路 🚝
單軌	單軌 🚝
山區鐵路	山區鐵路 🚞
有軌電車	有軌電車 🚋
公交車	公交車 🚌 🚍
公共汽車	公共汽車 🚌 🚍
公車	公車 🚌 🚍
大巴	大巴 🚌 🚍
巴士	巴士 🚌 🚍
無軌電車	無軌電車 🚎
電車	電車 🚎
麵包車	麵包車 🚐
小巴	小巴 🚐
五菱	五菱 🚐
五菱宏光	五菱宏光 🚐
救護車	救護車 🚑
急救車	急救車 🚑
消防車	消防車 🚒
救火車	救火車 🚒
警車	警車 🚓 🚔
報警	報警 🚔
出租車	出租車 🚕 🚖
的士	的士 🚕 🚖
汽車	汽車 🚗 🚘
轎車	轎車 🚗 🚘
小汽車	小汽車 🚗 🚘
小轎車	小轎車 🚗 🚘
私家車	私家車 🚗 🚘
車	車 🚗
越野車	越野車 🚙
SUV	SUV 🚙
休閒車	休閒車 🚙
運動型多用途車	運動型多用途車 🚙
皮卡	皮卡 🛻
皮卡車	皮卡車 🛻
送貨車	送貨車 🚚
貨車	貨車 🚚
物流	物流 🚚
拖車	拖車 🚛
卡車	卡車 🚛
大卡車	大卡車 🚛
拖拉機	拖拉機 🚜
賽車	賽車 🏎
方程式賽車	方程式賽車 🏎
摩托	摩托 🏍
摩托車	摩托車 🏍
小型摩托車	小型摩托車 🛵
電動車	電動車 🛵
電瓶車	電瓶車 🛵
小電驢	小電驢 🛵
輪椅	輪椅 🦽 ♿
殘疾人	殘疾人 🦽
嘟嘟車	嘟嘟車 🛺
三蹦子	三蹦子 🛺
三腳雞	三腳雞 🛺
三輪車	三輪車 🛺
三輪摩托車	三輪摩托車 🛺
自動人力車	自動人力車 🛺
單車	單車 🚲
自行車	自行車 🚲
腳踏車	腳踏車 🚲
滑板車	滑板車 🛴
滑板	滑板 🛹
輪滑	輪滑 🛼
輪滑鞋	輪滑鞋 🛼
旱冰	旱冰 🛼
旱冰鞋	旱冰鞋 🛼
滑旱冰	滑旱冰 🛼
四輪滑冰鞋	四輪滑冰鞋 🛼
公交站	公交站 🚏
公交車站	公交車站 🚏
公共汽車站	公共汽車站 🚏
高速公路	高速公路 🛣
高速	高速 🛣
公路	公路 🛣
鐵軌	鐵軌 🛤
油桶	油桶 🛢
加油站	加油站 ⛽
石油	石油 ⛽
車輪	車輪 🛞
車輪子	車輪子 🛞
輪胎	輪胎 🛞
輪子	輪子 🛞
軲轆	軲轆 🛞
車軲轆	車軲轆 🛞
警車旋轉燈	警車旋轉燈 🚨
警燈	警燈 🚨
警車燈	警車燈 🚨
報警燈	報警燈 🚨
交通信號燈	交通信號燈 🚥 🚦
交通燈	交通燈 🚥 🚦
信號燈	信號燈 🚥 🚦
紅綠燈	紅綠燈 🚥 🚦
八邊形	八邊形 🛑
施工符號	施工符號 🚧
施工中	施工中 🚧
前方施工	前方施工 🚧
路障	路障 🚧
錨	錨 ⚓
船錨	船錨 ⚓
救生圈	救生圈 🛟
游泳圈	游泳圈 🛟
泳圈	泳圈 🛟
救生	救生 🛟
帆船	帆船 ⛵
獨木舟	獨木舟 🛶
快艇	快艇 🚤
賽艇	賽艇 🚤
客輪	客輪 🛳
客船	客船 🛳
輪渡	輪渡 ⛴
渡輪	渡輪 ⛴
渡船	渡船 ⛴
摩托艇	摩托艇 🛥
輪船	輪船 🚢
郵輪	郵輪 🚢
海運	海運 🚢
船	船 🚢
飛機	飛機 ✈️
旅行	旅行 ✈️
小型飛機	小型飛機 🛩
飛機起飛	飛機起飛 🛫
航班起飛	航班起飛 🛫
起飛	起飛 🛫
飛機著陸	飛機著陸 🛬
航班降落	航班降落 🛬
降落	降落 🛬
著陸	著陸 🛬
降落傘	降落傘 🪂
跳傘	跳傘 🪂
座位	座位 💺
直升機	直升機 🚁
直升飛機	直升飛機 🚁
高架鐵路	高架鐵路 🚟
空中軌道列車	空中軌道列車 🚟
空軌	空軌 🚟
高山索道	高山索道 🚠
纜車	纜車 🚠 🚡
空中纜車	空中纜車 🚡
衛星	衛星 🛰
火箭	火箭 🚀
rocket	rocket 🚀
UFO	UFO 🛸
不明飛行物	不明飛行物 🛸
飛碟	飛碟 🛸
服務鈴	服務鈴 🛎
行李箱	行李箱 🧳
行李	行李 🧳
沙漏	沙漏 ⌛ ⏳
手錶	手錶 ⌚
時間	時間 ⌚
鬧鐘	鬧鐘 ⏰
鬧錶	鬧錶 ⏰
秒錶	秒錶 ⏱
計時器	計時器 ⏱
定時器	定時器 ⏲
檯鐘	檯鐘 🕰
壁爐鍾	壁爐鍾 🕰
座鐘	座鐘 🕰
十二點	十二點 🕛
十二點鐘	十二點鐘 🕛
十二點半	十二點半 🕧
一點鐘	一點鐘 🕐
一點半	一點半 🕜
兩點	兩點 🕑
兩點鐘	兩點鐘 🕑
兩點半	兩點半 🕝
三點	三點 🕒
三點鐘	三點鐘 🕒
三點半	三點半 🕞
四點	四點 🕓
四點鐘	四點鐘 🕓
四點半	四點半 🕟
五點	五點 🕔
五點鐘	五點鐘 🕔
五點半	五點半 🕠
六點	六點 🕕
六點鐘	六點鐘 🕕
六點半	六點半 🕡
七點	七點 🕖
七點鐘	七點鐘 🕖
七點半	七點半 🕢
八點	八點 🕗
八點鐘	八點鐘 🕗
八點半	八點半 🕣
九點	九點 🕘
九點鐘	九點鐘 🕘
九點半	九點半 🕤
十點	十點 🕙
十點鐘	十點鐘 🕙
十點半	十點半 🕥
十一點	十一點 🕚
十一點鐘	十一點鐘 🕚
十一點半	十一點半 🕦
新月	新月 🌑 🌚
朔月	朔月 🌑 🌚
眉月	眉月 🌒 🌘
蛾眉月	蛾眉月 🌒 🌘
殘月	殘月 🌒 🌘
月食	月食 🌒 🌘
上弦月	上弦月 🌓 🌛
盈凸月	盈凸月 🌔
滿月	滿月 🌕 🌝
圓月	圓月 🌕 🌝
月球	月球 🌕
虧凸月	虧凸月 🌖
下弦月	下弦月 🌗 🌜
月牙	月牙 🌙
月亮	月亮 🌙
彎月	彎月 🌙
微笑的新月	微笑的新月 🌚
微笑的朔月	微笑的朔月 🌚
微笑的上弦月	微笑的上弦月 🌛
微笑的下弦月	微笑的下弦月 🌜
溫度計	溫度計 🌡
太陽	太陽 ☀️ 🌞
日	日 ☀️
晴天	晴天 ☀️
微笑的月亮	微笑的月亮 🌝
微笑的滿月	微笑的滿月 🌝
微笑的太陽	微笑的太陽 🌞
行星	行星 🪐
土星	土星 🪐
有環行星	有環行星 🪐
星球	星球 🪐
五角星	五角星 ⭐
星星	星星 ⭐ 🌟 ✨
閃耀的星星	閃耀的星星 🌟
閃亮的星星	閃亮的星星 🌟
流星	流星 🌠
許願	許願 🌠
星空	星空 🌌
銀河	銀河 🌌
銀河系	銀河系 🌌
雲	雲 ☁️
雲彩	雲彩 ☁️
雲朵	雲朵 ☁️
cloud	cloud ☁️
天氣	天氣 ☁️
烏雲蔽日	烏雲蔽日 ⛅
多雲	多雲 ⛅
陰天	陰天 ⛅
雷陣雨	雷陣雨 ⛈️
大雨	大雨 ⛈️
下大雨	下大雨 ⛈️
少雲	少雲 🌤
晴偶有云	晴偶有云 🌤
白日小云	白日小云 🌤
下雨	下雨 🌧
雨	雨 🌧
雨雲	雨雲 🌧
下雪	下雪 🌨 ❄️
雪雲	雪雲 🌨
打雷	打雷 🌩
雷雲	雷雲 🌩
龍捲風	龍捲風 🌪
霧	霧 🌫
霾	霾 🌫
霧霾	霧霾 🌫
風吹拂的臉	風吹拂的臉 🌬
風吹拂	風吹拂 🌬
吹拂	吹拂 🌬
吹風	吹風 🌬
吹口氣	吹口氣 🌬
颱風	颱風 🌀
旋風	旋風 🌀
颶風	颶風 🌀
漩渦	漩渦 🌀
蚊香	蚊香 🌀
氣旋	氣旋 🌀
彩虹	彩虹 🌈
收起的傘	收起的傘 🌂
收起的雨傘	收起的雨傘 🌂
雨傘	雨傘 🌂 ☂️ ☔
打傘	打傘 ☂️ ☔
撐傘	撐傘 ☂️ ☔
傘狀	傘狀 ☂️
遮陽傘	遮陽傘 ⛱️
閃電	閃電 ⚡
高壓電	高壓電 ⚡
雪	雪 ❄️
雪花	雪花 ❄️
雪人	雪人 ⛄
堆雪人	堆雪人 ⛄
彗星	彗星 ☄️
哈雷	哈雷 ☄️
哈雷彗星	哈雷彗星 ☄️
火	火 🔥
火焰	火焰 🔥
燃燒	燃燒 🔥
點燃	點燃 🔥
著火	著火 🔥
著火了	著火了 🔥
火了	火了 🔥
汗滴	汗滴 💧
一滴水	一滴水 💧
一滴	一滴 💧
波浪	波浪 🌊
浪花	浪花 🌊
浪	浪 🌊
大浪	大浪 🌊
萬聖節	萬聖節 🎃
南瓜燈	南瓜燈 🎃
南瓜頭	南瓜頭 🎃
聖誕樹	聖誕樹 🎄
煙花	煙花 🎆 🎇
焰火	焰火 🎆 🎇
禮花	禮花 🎆 🎇
鞭炮	鞭炮 🧨
炸藥	炸藥 🧨
爆竹	爆竹 🧨
閃亮	閃亮 ✨
閃光	閃光 ✨
閃耀	閃耀 ✨
金光閃閃	金光閃閃 ✨
金閃閃	金閃閃 ✨
氣球	氣球 🎈
慶典	慶典 🎈
恭喜	恭喜 🎉
祝賀	祝賀 🎉
禮賓花	禮賓花 🎉
派對禮賓花	派對禮賓花 🎉
五彩紙屑球	五彩紙屑球 🎊
彩色碎紙	彩色碎紙 🎊
碎花彩球	碎花彩球 🎊
糖果球	糖果球 🎊
七夕	七夕 🎋
七夕樹	七夕樹 🎋
七夕節	七夕節 🎋
門松	門松 🎍
日本娃娃	日本娃娃 🎎
日本人形	日本人形 🎎
日本人偶	日本人偶 🎎
鯉魚旗	鯉魚旗 🎏
風鈴	風鈴 🎐
中秋	中秋 🎑
中秋節	中秋節 🎑
中秋佳節	中秋佳節 🎑
觀月	觀月 🎑
賞月	賞月 🎑
紅包	紅包 🧧
發紅包	發紅包 🧧
蝴蝶結	蝴蝶結 🎀
禮物	禮物 🎁
禮品	禮品 🎁
禮物盒	禮物盒 🎁
禮品盒	禮品盒 🎁
包裝	包裝 🎁
包裝盒	包裝盒 🎁
絲帶	絲帶 🎗
黃絲帶	黃絲帶 🎗
入場券	入場券 🎟
門票	門票 🎫
鞠躬勳章	鞠躬勳章 🎖
軍功章	軍功章 🎖
勳章	勳章 🎖
獎盃	獎盃 🏆
冠軍	冠軍 🏆
運動會獎牌	運動會獎牌 🏅
獎牌	獎牌 🏅
金牌	金牌 🥇
銀牌	銀牌 🥈
銅牌	銅牌 🥉
足球	足球 ⚽
英式足球	英式足球 ⚽
棒球	棒球 ⚾
壘球	壘球 🥎
籃球	籃球 🏀
排球	排球 🏐
橄欖球	橄欖球 🏈 🏉
美式橄欖球	美式橄欖球 🏈
美式足球	美式足球 🏈
英式橄欖球	英式橄欖球 🏉
網球	網球 🎾
飛盤	飛盤 🥏
保齡球	保齡球 🎳
保齡球瓶	保齡球瓶 🎳
板球	板球 🏏
板球拍	板球拍 🏏
曲棍球	曲棍球 🏑
冰球	冰球 🏒
袋棍球	袋棍球 🥍
乒乓球	乒乓球 🏓
乒乓球拍	乒乓球拍 🏓
羽毛球	羽毛球 🏸
羽毛球拍	羽毛球拍 🏸
球拍	球拍 🏸
拳擊手套	拳擊手套 🥊
武術服	武術服 🥋
空手道服	空手道服 🥋
跆拳道服	跆拳道服 🥋
柔道服	柔道服 🥋
球門網	球門網 🥅
球網	球網 🥅
球門	球門 🥅
高爾夫球洞	高爾夫球洞 ⛳
溜冰鞋	溜冰鞋 ⛸
溜冰	溜冰 ⛸
滑冰	滑冰 ⛸
釣魚竿	釣魚竿 🎣
漁竿	漁竿 🎣
釣竿	釣竿 🎣
釣魚	釣魚 🎣
潛水面罩	潛水面罩 🤿
深潛	深潛 🤿
潛水	潛水 🤿
運動背心	運動背心 🎽
滑雪橇	滑雪橇 🎿
滑雪裝備	滑雪裝備 🎿
雪橇	雪橇 🛷
乘雪橇	乘雪橇 🛷
駕雪橇	駕雪橇 🛷
坐雪橇	坐雪橇 🛷
冰上溜石	冰上溜石 🥌
溜石	溜石 🥌
冰壺	冰壺 🥌
靶心	靶心 🎯
正中靶心的飛鏢	正中靶心的飛鏢 🎯
飛鏢	飛鏢 🎯
命中	命中 🎯
溜溜球	溜溜球 🪀
悠悠球	悠悠球 🪀
風箏	風箏 🪁
放風箏	放風箏 🪁
風鳶	風鳶 🪁
紙鳶	紙鳶 🪁
水槍	水槍 🔫
玩具槍	玩具槍 🔫
滋水槍	滋水槍 🔫
檯球	檯球 🎱
黑八	黑八 🎱
水晶球	水晶球 🔮
占卜	占卜 🔮
魔法棒	魔法棒 🪄
魔棒	魔棒 🪄
手柄	手柄 🎮
遊戲手柄	遊戲手柄 🎮
視頻遊戲手柄	視頻遊戲手柄 🎮
電子遊戲手柄	電子遊戲手柄 🎮
操控杆	操控杆 🕹
遊戲操控杆	遊戲操控杆 🕹
搖桿	搖桿 🕹
遊戲搖桿	遊戲搖桿 🕹
老虎機	老虎機 🎰
賭場	賭場 🎰
賭博	賭博 🎰 🎲
色子	色子 🎲
骰子	骰子 🎲
酒桌遊戲	酒桌遊戲 🎲
拼圖	拼圖 🧩
拼圖塊	拼圖塊 🧩
拼塊	拼塊 🧩
拼塊兒	拼塊兒 🧩
泰迪熊	泰迪熊 🧸
泰迪	泰迪 🧸
皮納塔	皮納塔 🪅
鏡面球	鏡面球 🪩
迪斯科	迪斯科 🪩
俄羅斯套娃	俄羅斯套娃 🪆
套娃	套娃 🪆
撲克	撲克 ♠️ ♥️ ♦️ ♣️ 🃏
黑桃	黑桃 ♠️
紅桃	紅桃 ♥️
愛	愛 ♥️
心	心 ♥️
紅心	紅心 ♥️
方片	方片 ♦️
方板	方板 ♦️
梅花	梅花 ♣️
草花	草花 ♣️
國際象棋兵	國際象棋兵 ♟
國際象棋	國際象棋 ♟
大小王	大小王 🃏
大王	大王 🃏
小王	小王 🃏
小丑牌	小丑牌 🃏
鬼牌	鬼牌 🃏
joker	joker 🃏
紅中	紅中 🀄
中	中 🀄
麻將	麻將 🀄
花撲克牌	花撲克牌 🎴
撲克牌	撲克牌 🎴
表演藝術	表演藝術 🎭
面具	面具 🎭
帶畫框的圖片	帶畫框的圖片 🖼
帶框的畫	帶框的畫 🖼
畫框	畫框 🖼
一幅畫	一幅畫 🖼
畫畫	畫畫 🎨
調色板	調色板 🎨
調色盤	調色盤 🎨
藝術	藝術 🎨
美術	美術 🎨
線軸	線軸 🧵
針	針 🪡
繡花針	繡花針 🪡
縫紉針	縫紉針 🪡
線團	線團 🧶
毛線	毛線 🧶
紗線	紗線 🧶
毛線球	毛線球 🧶
繩子	繩子 🪢
繩結	繩結 🪢
打結	打結 🪢
眼鏡	眼鏡 👓
近視	近視 👓
近視眼	近視眼 👓
護目鏡	護目鏡 🥽
泳鏡	泳鏡 🥽
游泳鏡	游泳鏡 🥽
實驗室外衣	實驗室外衣 🥼
白大褂	白大褂 🥼
白大褂兒	白大褂兒 🥼
安全背心	安全背心 🦺
救生衣	救生衣 🦺
襯衫領帶	襯衫領帶 👔
領帶	領帶 👔
衣服	衣服 👔
襯衫	襯衫 👕
恤衫	恤衫 👕
短袖	短袖 👕
上衣	上衣 👕
T恤	T恤 👕
T恤衫	T恤衫 👕
男襯衫	男襯衫 👕
男士襯衫	男士襯衫 👕
汗衫	汗衫 👕
牛仔褲	牛仔褲 👖
褲子	褲子 👖
圍巾	圍巾 🧣
手套	手套 🧤
外套	外套 🧥
夾克	夾克 🧥
夾克衫	夾克衫 🧥
襪子	襪子 🧦
短襪	短襪 🧦
連衣裙	連衣裙 👗
長裙	長裙 👗
裙子	裙子 👗
和服	和服 👘
浴衣	浴衣 👘
紗麗	紗麗 🥻
連體泳衣	連體泳衣 🩱
泳衣	泳衣 🩱
泳裝	泳裝 🩱 👙
三角褲	三角褲 🩲
內褲	內褲 🩲
底褲	底褲 🩲
四角褲	四角褲 🩳
短褲	短褲 🩳
三點式	三點式 👙
比基尼	比基尼 👙
內衣	內衣 👙
女裝	女裝 👚
女士襯衫	女士襯衫 👚
女襯衫	女襯衫 👚
扇子	扇子 🪭
摺扇	摺扇 🪭
錢包	錢包 👛
零錢包	零錢包 👛
女士錢包	女士錢包 👛
手提包	手提包 👜
挎包	挎包 👜
女包	女包 👜
包包	包包 👜
手拿包	手拿包 👝
荷包	荷包 👝
皮包	皮包 👝
購物袋	購物袋 🛍
書包	書包 🎒
雙肩包	雙肩包 🎒
揹包	揹包 🎒
背囊	背囊 🎒
涼鞋	涼鞋 🩴 👡
夾趾涼鞋	夾趾涼鞋 🩴
沙灘涼鞋	沙灘涼鞋 🩴
拖鞋	拖鞋 🩴
人字拖	人字拖 🩴
皮鞋	皮鞋 👞
男鞋	男鞋 👞
網球鞋	網球鞋 👟
跑鞋	跑鞋 👟
運動鞋	運動鞋 👟
板鞋	板鞋 👟
板兒鞋	板兒鞋 👟
休閒鞋	休閒鞋 👟
鞋子	鞋子 👟
登山鞋	登山鞋 🥾
平底鞋	平底鞋 🥿
高跟鞋	高跟鞋 👠
高跟兒	高跟兒 👠
高跟兒鞋	高跟兒鞋 👠
女鞋	女鞋 👠
女式涼鞋	女式涼鞋 👡
高跟涼鞋	高跟涼鞋 👡
高跟兒涼鞋	高跟兒涼鞋 👡
芭蕾舞鞋	芭蕾舞鞋 🩰
足尖鞋	足尖鞋 🩰
高跟靴	高跟靴 👢
高跟兒靴	高跟兒靴 👢
女靴	女靴 👢
靴子	靴子 👢
長靴	長靴 👢
叉梳	叉梳 🪮
梳子	梳子 🪮
王冠	王冠 👑
皇冠	皇冠 👑
皇族	皇族 👑
帶蝴蝶結的帽子	帶蝴蝶結的帽子 👒
女帽	女帽 👒
寬簷帽	寬簷帽 👒
帽子	帽子 🎩
禮帽	禮帽 🎩
高帽	高帽 🎩
四方帽	四方帽 🎓
畢業帽	畢業帽 🎓
學士帽	學士帽 🎓
棒球帽	棒球帽 🧢
鴨舌帽	鴨舌帽 🧢
軍用頭盔	軍用頭盔 🪖
頭盔	頭盔 🪖
軍人	軍人 🪖
軍盔	軍盔 🪖
安全帽	安全帽 ⛑️
白十字頭盔	白十字頭盔 ⛑️
白十字安全帽	白十字安全帽 ⛑️
十字安全帽	十字安全帽 ⛑️
十字頭盔	十字頭盔 ⛑️
念珠	念珠 📿
口紅	口紅 💄
唇膏	唇膏 💄
戒指	戒指 💍
鑽戒	鑽戒 💍
求婚戒	求婚戒 💍
訂婚戒	訂婚戒 💍
星鑽	星鑽 💍
寶石	寶石 💎
鑽石	鑽石 💎
已靜音的揚聲器	已靜音的揚聲器 🔇
揚聲器關閉	揚聲器關閉 🔇
靜音	靜音 🔇
揚聲器	揚聲器 🔈 🔉 🔊
中等音量	中等音量 🔉
中等音量的揚聲器	中等音量的揚聲器 🔉
大音量	大音量 🔊
高音量	高音量 🔊
高音量的揚聲器	高音量的揚聲器 🔊
公共廣播	公共廣播 📢
喇叭	喇叭 📢 📣
喇叭筒	喇叭筒 📣
大喇叭	大喇叭 📣
郵政喇叭	郵政喇叭 📯
鈴鐺	鈴鐺 🔔
靜音鈴鐺	靜音鈴鐺 🔕
響鈴關閉	響鈴關閉 🔕
禁止響鈴	禁止響鈴 🔕
樂譜	樂譜 🎼
五線譜	五線譜 🎼
音符	音符 🎵 🎶
音樂	音樂 🎵 🎶
麥克風	麥克風 🎙 🎤
錄音室麥克風	錄音室麥克風 🎙
錄音麥克風	錄音麥克風 🎙
電平滑塊	電平滑塊 🎚
滑塊	滑塊 🎚
控制旋鈕	控制旋鈕 🎛
旋鈕	旋鈕 🎛
頭戴式耳機	頭戴式耳機 🎧
耳機	耳機 🎧
收音機	收音機 📻
無線電	無線電 📻
電臺	電臺 📻
薩克斯	薩克斯 🎷
薩克斯風	薩克斯風 🎷
薩克斯管	薩克斯管 🎷
管絃樂器	管絃樂器 🎷
手風琴	手風琴 🪗
吉他	吉他 🎸
電吉他	電吉他 🎸
音樂鍵盤	音樂鍵盤 🎹
鋼琴	鋼琴 🎹
鋼琴按鍵	鋼琴按鍵 🎹
鋼琴鍵	鋼琴鍵 🎹
琴鍵	琴鍵 🎹
小號	小號 🎺
小提琴	小提琴 🎻
提琴	提琴 🎻
班卓琴	班卓琴 🪕
鼓	鼓 🥁
打鼓	打鼓 🥁
敲鼓	敲鼓 🥁
長鼓	長鼓 🪘
康加鼓	康加鼓 🪘
沙錘	沙錘 🪇
笛子	笛子 🪈
長笛	長笛 🪈
豎笛	豎笛 🪈
移動電話	移動電話 📱
手機	手機 📱
智能手機	智能手機 📱
來電	來電 📲
手機來電	手機來電 📲
電話	電話 ☎️
固定電話	固定電話 ☎️
固話	固話 ☎️
座機	座機 ☎️
電話聽筒	電話聽筒 📞
電話筒	電話筒 📞
傳呼機	傳呼機 📟
呼機	呼機 📟
尋呼機	尋呼機 📟
傳真	傳真 📠
傳真機	傳真機 📠
發傳真	發傳真 📠
電池	電池 🔋
電量	電量 🔋 🪫
電源	電源 🔋 🔌
蓄電池	蓄電池 🔋
低電量	低電量 🪫
電量低	電量低 🪫
電池不足	電池不足 🪫
電量不足	電量不足 🪫
插頭	插頭 🔌
電插頭	電插頭 🔌
電源插頭	電源插頭 🔌
筆記本電腦	筆記本電腦 💻
個人電腦	個人電腦 💻
手提電腦	手提電腦 💻
筆電	筆電 💻
臺式電腦	臺式電腦 🖥
電腦	電腦 🖥
顯示器	顯示器 🖥
顯示屏	顯示屏 🖥
計算機	計算機 🖥
打印機	打印機 🖨
印刷機	印刷機 🖨
鍵盤	鍵盤 ⌨️
電腦鍵盤	電腦鍵盤 ⌨️
電腦鼠標	電腦鼠標 🖱
鼠標	鼠標 🖱
軌跡球	軌跡球 🖲
光盤	光盤 💽
光碟	光碟 💽
迷你光盤	迷你光盤 💽
迷你光碟	迷你光碟 💽
電腦光盤	電腦光盤 💽
軟盤	軟盤 💾
CD	CD 💿
DVD	DVD 📀
算盤	算盤 🧮
打算盤	打算盤 🧮
攝像機	攝像機 🎥 📹
攝錄機	攝錄機 🎥
攝影機	攝影機 🎥
電影攝影機	電影攝影機 🎥
電影膠片	電影膠片 🎞
膠捲	膠捲 🎞
膠片	膠片 🎞
電影	電影 🎞
菲林	菲林 🎞
電影放映機	電影放映機 📽
放映機	放映機 📽
上映	上映 📽
場記	場記 🎬
場記板	場記板 🎬
打板	打板 🎬
拍電影	拍電影 🎬
action	action 🎬
電視	電視 📺
電視機	電視機 📺
TV	TV 📺
相機	相機 📷
卡片相機	卡片相機 📷
照相機	照相機 📷
開閃光燈的相機	開閃光燈的相機 📸
拍照	拍照 📸
閃光燈	閃光燈 📸
閃光燈打開	閃光燈打開 📸
錄像帶	錄像帶 📼
錄影帶	錄影帶 📼
磁帶	磁帶 📼
放大鏡	放大鏡 🔍 🔎
蠟燭	蠟燭 🕯
燭光	燭光 🕯
燭火	燭火 🕯
燈泡	燈泡 💡
電燈泡	電燈泡 💡
白熾燈	白熾燈 💡
燈	燈 💡
電燈	電燈 💡
手電	手電 🔦
手電筒	手電筒 🔦
電筒	電筒 🔦
照明	照明 🔦
居酒屋燈籠	居酒屋燈籠 🏮
居酒屋	居酒屋 🏮
燈籠	燈籠 🏮
紅燈籠	紅燈籠 🏮
大紅燈籠	大紅燈籠 🏮
大紅燈籠高高掛	大紅燈籠高高掛 🏮
油燈	油燈 🪔
筆記本	筆記本 📔 📓 📒
記事本	記事本 📔 📓 📒
日記本	日記本 📔 📓 📒
紅色的書	紅色的書 📕
紅色書本	紅色書本 📕
小紅書	小紅書 📕
第一卷	第一卷 📕
書	書 📖 📚
圖書	圖書 📖 📚
書本	書本 📖 📚
書籍	書籍 📖 📚
打開的書	打開的書 📖
打開的書本	打開的書本 📖
綠色的書	綠色的書 📗
綠色書本	綠色書本 📗
教科書	教科書 📗
第二卷	第二卷 📗
藍色的書	藍色的書 📘
藍色書本	藍色書本 📘
第三卷	第三卷 📘
橙色的書	橙色的書 📙
橙色書本	橙色書本 📙
橘色的書	橘色的書 📙
橘色書本	橘色書本 📙
第四卷	第四卷 📙
賬簿	賬簿 📒
帶卷邊的紙	帶卷邊的紙 📃
卷邊的紙	卷邊的紙 📃
卷軸	卷軸 📜
紙	紙 📄
文書	文書 📄
文件	文件 📄
報紙	報紙 📰
新聞	新聞 📰
捲起的報紙	捲起的報紙 🗞
報紙卷	報紙卷 🗞
書籤標籤	書籤標籤 📑
標籤頁	標籤頁 📑
頁籤	頁籤 📑
書籤	書籤 🔖
標籤	標籤 🏷
吊牌	吊牌 🏷
錢	錢 💰
金錢	金錢 💰 💲
錢袋	錢袋 💰
工資	工資 💰
獎金	獎金 💰
money	money 💰
硬幣	硬幣 🪙
鋼鏰	鋼鏰 🪙
鋼鏰兒	鋼鏰兒 🪙
錢幣	錢幣 🪙
日元鈔票	日元鈔票 💴
美元鈔票	美元鈔票 💵
鈔票	鈔票 💵
紙幣	紙幣 💵
歐元鈔票	歐元鈔票 💶
英鎊鈔票	英鎊鈔票 💷
長翅膀的錢	長翅膀的錢 💸
長了翅膀的錢	長了翅膀的錢 💸
翅膀錢	翅膀錢 💸
花錢	花錢 💸
錢飛了	錢飛了 💸
信用卡	信用卡 💳
借記卡	借記卡 💳
貸記卡	貸記卡 💳
銀行卡	銀行卡 💳
憑據	憑據 🧾
發票	發票 🧾
收據	收據 🧾
賬單	賬單 🧾
信件	信件 ✉️
信封	信封 ✉️
寫信	寫信 ✉️
電子郵件	電子郵件 📧
郵件	郵件 📧
email	email 📧
來信	來信 📨
收到來信	收到來信 📨
收到郵件	收到郵件 📨 📥
新郵件	新郵件 📨
發件	發件 📤
發件箱	發件箱 📤
發信	發信 📤
發郵件	發郵件 📤
收件	收件 📥
收件箱	收件箱 📥
收信	收信 📥
收郵件	收郵件 📥
包裹	包裹 📦
快遞	快遞 📦
紙箱	紙箱 📦
紙箱子	紙箱子 📦
箱子	箱子 📦
打包	打包 📦
盒子	盒子 📦
信箱	信箱 📪
郵筒	郵筒 📮
郵箱	郵箱 📮
投票	投票 🗳
投票箱	投票箱 🗳
選票	選票 🗳
鉛筆	鉛筆 ✏️
鋼筆	鋼筆 ✒️ 🖋
圓珠筆	圓珠筆 🖊
畫筆	畫筆 🖌
蠟筆	蠟筆 🖍
備忘錄	備忘錄 📝
備忘	備忘 📝
便箋	便箋 📝
公文包	公文包 💼
公事包	公事包 💼
上班	上班 💼
工作	工作 💼
文件夾	文件夾 📁 📂
卡片索引分隔卡	卡片索引分隔卡 🗂
日曆	日曆 📅
手撕日曆	手撕日曆 📆
線圈筆記本	線圈筆記本 🗒
線圈本	線圈本 🗒
線圈日曆	線圈日曆 🗓
卡片索引	卡片索引 📇
卡牌索引	卡牌索引 📇
上升	上升 📈
上漲	上漲 📈
暴漲	暴漲 📈
下降	下降 📉
下跌	下跌 📉
暴跌	暴跌 📉
圖表	圖表 📊
條形圖	條形圖 📊
柱形圖	柱形圖 📊
柱狀圖	柱狀圖 📊
寫字板	寫字板 📋
剪貼板	剪貼板 📋
圖釘	圖釘 📌
圓圖釘	圓圖釘 📍
大頭針	大頭針 📍
回形針	回形針 📎 🖇
曲別針	曲別針 📎 🖇
直尺	直尺 📏
尺子	尺子 📏
三角尺	三角尺 📐
三角板	三角板 📐
剪刀	剪刀 ✂️
剪子	剪子 ✂️
卡片盒	卡片盒 🗃
卡片存檔盒	卡片存檔盒 🗃
文件櫃	文件櫃 🗄
廢紙簍	廢紙簍 🗑
垃圾桶	垃圾桶 🗑
垃圾簍	垃圾簍 🗑
垃圾	垃圾 🗑
鎖	鎖 🔒 🔓
合上的鎖	合上的鎖 🔒
門鎖	門鎖 🔒 🔓
鎖頭	鎖頭 🔒 🔓
上鎖	上鎖 🔒
鎖上	鎖上 🔒
鎖住	鎖住 🔒
打開的鎖	打開的鎖 🔓
解鎖	解鎖 🔓 🔐
開鎖	開鎖 🔓
帶墨水筆的鎖	帶墨水筆的鎖 🔏
隱秘	隱秘 🔏
已鎖上但掛著鑰匙的鎖	已鎖上但掛著鑰匙的鎖 🔐
密鑰	密鑰 🔐
鑰匙	鑰匙 🔑 🗝
古老的鑰匙	古老的鑰匙 🗝
老鑰匙	老鑰匙 🗝
舊鑰匙	舊鑰匙 🗝
老式鑰匙	老式鑰匙 🗝
復古鑰匙	復古鑰匙 🗝
錘子	錘子 🔨
鐵錘	鐵錘 🔨
斧子	斧子 🪓
斧頭	斧頭 🪓
鐵鎬	鐵鎬 ⛏️
鋤頭	鋤頭 ⛏️
鶴嘴鋤	鶴嘴鋤 ⛏️
錘子與鎬	錘子與鎬 ⚒️
錘子和鎬	錘子和鎬 ⚒️
錘子和扳手	錘子和扳手 🛠
錘子與扳手	錘子與扳手 🛠
錘子扳手	錘子扳手 🛠
工具	工具 🛠
匕首	匕首 🗡
短刀	短刀 🗡
短劍	短劍 🗡
雙劍	雙劍 ⚔️
雙劍交叉	雙劍交叉 ⚔️
戰鬥	戰鬥 ⚔️
開戰	開戰 ⚔️
開始戰鬥	開始戰鬥 ⚔️
fight	fight ⚔️
炸彈	炸彈 💣
boom	boom 💣
迴旋鏢	迴旋鏢 🪃
飛旋鏢	飛旋鏢 🪃
回力棒	回力棒 🪃
回力鏢	回力鏢 🪃
飛去來器	飛去來器 🪃
回飛棒	回飛棒 🪃
弓箭	弓箭 🏹
弓和箭	弓和箭 🏹
盾牌	盾牌 🛡
手鋸	手鋸 🪚
鋸子	鋸子 🪚
扳手	扳手 🔧
螺絲扳手	螺絲扳手 🔧
螺絲刀	螺絲刀 🪛
螺母及螺栓	螺母及螺栓 🔩
螺母與螺栓	螺母與螺栓 🔩
螺母和螺栓	螺母和螺栓 🔩
螺母螺栓	螺母螺栓 🔩
齒輪	齒輪 ⚙️
夾鉗	夾鉗 🗜
天平	天平 ⚖️
白手杖	白手杖 🦯
手杖	手杖 🦯
鏈接	鏈接 🔗
link	link 🔗
鏈條	鏈條 ⛓️
鐵鏈	鐵鏈 ⛓️
鎖鏈	鎖鏈 ⛓️
鏈子	鏈子 ⛓️
鐵鏈子	鐵鏈子 ⛓️
鉤子	鉤子 🪝
掛鉤	掛鉤 🪝
鐵鉤	鐵鉤 🪝
彎鉤	彎鉤 🪝
工具箱	工具箱 🧰
磁鐵	磁鐵 🧲
吸鐵石	吸鐵石 🧲
磁力	磁力 🧲
磁石	磁石 🧲
梯子	梯子 🪜
爬梯	爬梯 🪜
爬梯子	爬梯子 🪜
搭梯子	搭梯子 🪜
翻牆	翻牆 🪜
科學上網	科學上網 🪜
魔法上網	魔法上網 🪜
蒸餾器	蒸餾器 ⚗️
試管	試管 🧪
培養皿	培養皿 🧫
DNA	DNA 🧬
脫氧核糖核酸	脫氧核糖核酸 🧬
基因	基因 🧬
顯微鏡	顯微鏡 🔬
望遠鏡	望遠鏡 🔭
衛星天線	衛星天線 📡
天線	天線 📡
接收天線	接收天線 📡
注射器	注射器 💉
打針	打針 💉
血滴	血滴 🩸
滴血	滴血 🩸
藥丸	藥丸 💊
膠囊	膠囊 💊
創可貼	創可貼 🩹
創口貼	創口貼 🩹
柺杖	柺杖 🩼
聽診器	聽診器 🩺
X射線	X射線 🩻
X光	X光 🩻
X光片	X光片 🩻
拍片	拍片 🩻
胸透	胸透 🩻
胸片	胸片 🩻
門	門 🚪
房門	房門 🚪
門子	門子 🚪
電梯	電梯 🛗
升降機	升降機 🛗
鏡子	鏡子 🪞
魔鏡	魔鏡 🪞
窗戶	窗戶 🪟
床	床 🛏
沙發和燈	沙發和燈 🛋
沙發	沙發 🛋
椅子	椅子 🪑
凳子	凳子 🪑
馬桶	馬桶 🚽
馬桶吸	馬桶吸 🪠
搋子	搋子 🪠
馬桶搋	馬桶搋 🪠
馬桶搋子	馬桶搋子 🪠
水拔子	水拔子 🪠
皮老虎	皮老虎 🪠
馬桶吸盤	馬桶吸盤 🪠
吸把	吸把 🪠
馬桶吸把	馬桶吸把 🪠
馬桶疏通器	馬桶疏通器 🪠
通通樂	通通樂 🪠
馬桶塞	馬桶塞 🪠
馬桶抽子	馬桶抽子 🪠
淋浴	淋浴 🚿
噴頭	噴頭 🚿
浴缸	浴缸 🛁
捕鼠器	捕鼠器 🪤
剃刀	剃刀 🪒
剃鬚刀	剃鬚刀 🪒
刮鬍刀	刮鬍刀 🪒
手動刮鬍刀	手動刮鬍刀 🪒
乳液	乳液 🧴
乳液瓶	乳液瓶 🧴
護膚霜	護膚霜 🧴
洗髮水	洗髮水 🧴
沐浴露	沐浴露 🧴
洗髮露	洗髮露 🧴
安全別針	安全別針 🧷
別針	別針 🧷
釦針	釦針 🧷
掃帚	掃帚 🧹
掃把	掃把 🧹
笤帚	笤帚 🧹
籃子	籃子 🧺
竹籃	竹籃 🧺
菜籃	菜籃 🧺
菜籃子	菜籃子 🧺
衛生紙	衛生紙 🧻
捲紙	捲紙 🧻
紙巾	紙巾 🧻
水桶	水桶 🪣
圓桶	圓桶 🪣
肥皂	肥皂 🧼
香皂	香皂 🧼
泡泡	泡泡 🫧
氣泡	氣泡 🫧
牙刷	牙刷 🪥
刷牙	刷牙 🪥
海綿	海綿 🧽
清洗	清洗 🧽
滅火器	滅火器 🧯
購物車	購物車 🛒
手推車	手推車 🛒
煙	煙 🚬
香菸	香菸 🚬
捲菸	捲菸 🚬
紙菸	紙菸 🚬
吸菸	吸菸 🚬
抽菸	抽菸 🚬
烤煙	烤煙 🚬
點菸	點菸 🚬
來一根	來一根 🚬
來一根兒	來一根兒 🚬
一支菸	一支菸 🚬
棺材	棺材 ⚰️
靈柩	靈柩 ⚰️
墓碑	墓碑 🪦
墳墓	墳墓 🪦
骨灰盒	骨灰盒 ⚱️
骨灰缸	骨灰缸 ⚱️
奉金甕	奉金甕 ⚱️
黃金甕	黃金甕 ⚱️
金甕	金甕 ⚱️
金塔	金塔 ⚱️
骨甕	骨甕 ⚱️
骨罈	骨罈 ⚱️
惡魔之眼	惡魔之眼 🧿
惡魔眼	惡魔眼 🧿
惡魔的眼	惡魔的眼 🧿
法蒂瑪	法蒂瑪 🪬
法蒂瑪之手	法蒂瑪之手 🪬
復活島	復活島 🗿
復活節島	復活節島 🗿
復活節島石像	復活節島石像 🗿
摩艾石像	摩艾石像 🗿
標語	標語 🪧
佈告	佈告 🪧
佈告牌	佈告牌 🪧
標語牌	標語牌 🪧
身份證	身份證 🪪 🆔
ID	ID 🪪 🆔
駕照	駕照 🪪
執照	執照 🪪
證件	證件 🪪
證照	證照 🪪
ATM	ATM 🏧
取款機	取款機 🏧
提款機	提款機 🏧
垃圾入簍標誌	垃圾入簍標誌 🚮
垃圾入簍	垃圾入簍 🚮
垃圾丟棄處	垃圾丟棄處 🚮
丟垃圾	丟垃圾 🚮
扔垃圾	扔垃圾 🚮
倒垃圾	倒垃圾 🚮
水龍頭	水龍頭 🚰
飲用水	飲用水 🚰
直飲水	直飲水 🚰
飲水處	飲水處 🚰
輪椅標誌	輪椅標誌 ♿
男士標誌	男士標誌 🚹
男士符號	男士符號 🚹
男士	男士 🚹
男廁	男廁 🚹
男廁所	男廁所 🚹
男洗手間	男洗手間 🚹
女士標誌	女士標誌 🚺
女士符號	女士符號 🚺
女士	女士 🚺
女廁	女廁 🚺
女廁所	女廁所 🚺
女洗手間	女洗手間 🚺
衛生間	衛生間 🚻 🚾
廁所	廁所 🚻 🚾
洗手間	洗手間 🚻
盥洗室	盥洗室 🚻
嬰兒符號	嬰兒符號 🚼
嬰兒標誌	嬰兒標誌 🚼
WC	WC 🚾
護照檢查處	護照檢查處 🛂
安檢	安檢 🛂
護照檢查	護照檢查 🛂
檢查護照	檢查護照 🛂
海關	海關 🛃
海關檢查	海關檢查 🛃
行李領取處	行李領取處 🛄
行李領取	行李領取 🛄
領取行李	領取行李 🛄
行李寄存處	行李寄存處 🛅
行李寄存	行李寄存 🛅
寄存行李	寄存行李 🛅
警告	警告 ⚠️
注意	注意 ⚠️
危險	危險 ⚠️
預警	預警 ⚠️
學童過街	學童過街 🚸
兒童過街	兒童過街 🚸
注意兒童	注意兒童 🚸
當心兒童	當心兒童 🚸
禁止駛入	禁止駛入 ⛔
禁止通行	禁止通行 ⛔
請勿入內	請勿入內 ⛔
請勿駛入	請勿駛入 ⛔
禁止	禁止 🚫 🈲
嚴禁	嚴禁 🚫 🈲
不準	不準 🚫
不許	不許 🚫
禁止騎車	禁止騎車 🚳
禁止騎行	禁止騎行 🚳
禁止自行車	禁止自行車 🚳
禁止吸菸	禁止吸菸 🚭
請勿吸菸	請勿吸菸 🚭
禁菸	禁菸 🚭
勿扔垃圾	勿扔垃圾 🚯
勿丟垃圾	勿丟垃圾 🚯
請勿亂丟垃圾	請勿亂丟垃圾 🚯
請勿亂扔垃圾	請勿亂扔垃圾 🚯
禁丟垃圾	禁丟垃圾 🚯
禁止扔垃圾	禁止扔垃圾 🚯
禁止丟垃圾	禁止丟垃圾 🚯
禁止亂扔垃圾	禁止亂扔垃圾 🚯
禁止亂丟垃圾	禁止亂丟垃圾 🚯
非飲用水	非飲用水 🚱
請勿飲用	請勿飲用 🚱
禁止行人	禁止行人 🚷
禁止行人通行	禁止行人通行 🚷
禁止使用手機	禁止使用手機 📵
禁止打電話	禁止打電話 📵
十八禁	十八禁 🔞
未成年	未成年 🔞
未成年不宜	未成年不宜 🔞
成人	成人 🔞
放射性	放射性 ☢️
輻射	輻射 ☢️
生物危害	生物危害 ☣️
生化危機	生化危機 ☣️
瘟疫公司	瘟疫公司 ☣️
上	上 ⬆️ ↑
上箭頭	上箭頭 ⬆️ ↑
向上箭頭	向上箭頭 ⬆️
右上	右上 ↗️ ↗
右上箭頭	右上箭頭 ↗️ ↗
右	右 ➡️ →
右箭頭	右箭頭 ➡️ →
向右箭頭	向右箭頭 ➡️
右下	右下 ↘️ ↘
右下箭頭	右下箭頭 ↘️ ↘
下	下 ⬇️ ↓
下箭頭	下箭頭 ⬇️ ↓
向下箭頭	向下箭頭 ⬇️
左下	左下 ↙️ ↙
左下箭頭	左下箭頭 ↙️ ↙
左	左 ⬅️ ←
左箭頭	左箭頭 ⬅️ ←
向左箭頭	向左箭頭 ⬅️
左上	左上 ↖️ ↖
左上箭頭	左上箭頭 ↖️ ↖
上下	上下 ↕️ ↕
上下箭頭	上下箭頭 ↕️ ↕
左右	左右 ↔️ ↔︎
左右箭頭	左右箭頭 ↔️ ↔︎
回車	回車 ↩️
重新載入	重新載入 🔃
順時針	順時針 🔃
順時針方向	順時針方向 🔃
順時針垂直箭頭	順時針垂直箭頭 🔃
逆時針	逆時針 🔄
逆時針方向	逆時針方向 🔄
逆時針垂直箭頭	逆時針垂直箭頭 🔄
back	back 🔙
退回	退回 🔙
end	end 🔚
結束	結束 🔚
on	on 🔛
開啟	開啟 🔛
soon	soon 🔜
馬上	馬上 🔜
top	top 🔝
禱告	禱告 🛐
原子符號	原子符號 ⚛️
原子	原子 ⚛️
atom	atom ⚛️
奧姆	奧姆 🕉
奧姆符號	奧姆符號 🕉
大衛之星	大衛之星 ✡️
法輪	法輪 ☸️
太極	太極 ☯️
陰陽	陰陽 ☯️
十字架	十字架 ✝️
基督	基督 ✝️
基督教	基督教 ✝️
東正教	東正教 ☦️
東正教十字架	東正教十字架 ☦️
星月	星月 ☪️
和平	和平 ☮️
和平符號	和平符號 ☮️
和平標誌	和平標誌 ☮️
世界和平	世界和平 ☮️
peace	peace ☮️
光明節	光明節 🕎
六角星	六角星 🔯
六芒星	六芒星 🔯
魔法陣	魔法陣 🔯
錫克	錫克 🪯
錫克教	錫克教 🪯
坎達	坎達 🪯
坎達符號	坎達符號 🪯
白羊座	白羊座 ♈
金牛座	金牛座 ♉
雙子座	雙子座 ♊
巨蟹座	巨蟹座 ♋
獅子座	獅子座 ♌
處女座	處女座 ♍
天秤座	天秤座 ♎
天蠍座	天蠍座 ♏
射手座	射手座 ♐
摩羯座	摩羯座 ♑
水瓶座	水瓶座 ♒
雙魚座	雙魚座 ♓
蛇夫座	蛇夫座 ⛎
隨機播放	隨機播放 🔀
隨機	隨機 🔀
交叉箭頭	交叉箭頭 🔀
循環播放	循環播放 🔁
單曲循環	單曲循環 🔂
播放	播放 ▶️
開始	開始 ▶️
開始播放	開始播放 ▶️
快進	快進 ⏩
快進符號	快進符號 ⏩
下一首	下一首 ⏭️
播放暫停	播放暫停 ⏯️
倒退	倒退 ◀️
倒退按鈕	倒退按鈕 ◀️
快退	快退 ⏪
快退符號	快退符號 ⏪
上一首	上一首 ⏮️
上三角	上三角 🔼
調高	調高 🔼
快上	快上 ⏫
下三角	下三角 🔽
調低	調低 🔽
快下	快下 ⏬
暫停	暫停 ⏸️
停止	停止 ⏹️
錄音	錄音 ⏺️
錄音按鈕	錄音按鈕 ⏺️
開始錄音	開始錄音 ⏺️
錄像	錄像 ⏺️
錄像按鈕	錄像按鈕 ⏺️
開始錄像	開始錄像 ⏺️
彈出	彈出 ⏏️
推出	推出 ⏏️
彈出按鈕	彈出按鈕 ⏏️
推出按鈕	推出按鈕 ⏏️
電影院	電影院 🎦
亮度	亮度 🔅 🔆
亮度低	亮度低 🔅
低亮度	低亮度 🔅
亮度高	亮度高 🔆
高亮度	高亮度 🔆
信號強度條	信號強度條 📶
信號強度	信號強度 📶
信號	信號 📶
手機信號	手機信號 📶
wireless	wireless 🛜
WiFi	WiFi 🛜
Wi-Fi	Wi-Fi 🛜
無線局域網	無線局域網 🛜
無線網	無線網 🛜
無線網絡	無線網絡 🛜
網絡	網絡 🛜
震動	震動 📳
振動模式	振動模式 📳
關機	關機 📴
手機關機	手機關機 📴
關閉手機	關閉手機 📴
女	女 ♀
女性	女性 ♀
男	男 ♂
男性	男性 ♂
跨性別	跨性別 ⚧ 🏳️‍⚧️
跨性別符號	跨性別符號 ⚧
變性	變性 ⚧
乘	乘 ✖️
乘以	乘以 ✖️
乘號	乘號 ✖️
加	加 ➕
加號	加號 ➕
減	減 ➖
減號	減號 ➖
除	除 ➗
除以	除以 ➗
除號	除號 ➗
等於	等於 🟰
等號	等號 🟰
等於號	等於號 🟰
粗等號	粗等號 🟰
雙感嘆號	雙感嘆號 ‼️
雙驚歎號	雙驚歎號 ‼️
雙歎號	雙歎號 ‼️
倆歎號	倆歎號 ‼️
疑問驚歎號	疑問驚歎號 ⁉️
疑問驚歎	疑問驚歎 ⁉️
嘆問號	嘆問號 ⁉️
歎號問號	歎號問號 ⁉️
感嘆號問號	感嘆號問號 ⁉️
驚問	驚問 ⁉️
問號	問號 ❓ ❔
白色問號	白色問號 ❔
白問號	白問號 ❔
感嘆號	感嘆號 ❗ ❕
驚歎號	驚歎號 ❗ ❕
歎號	歎號 ❗ ❕
白色感嘆號	白色感嘆號 ❕
白色驚歎號	白色驚歎號 ❕
白色歎號	白色歎號 ❕
白感嘆號	白感嘆號 ❕
白驚歎號	白驚歎號 ❕
白歎號	白歎號 ❕
波浪型破折號	波浪型破折號 〰️
波浪線	波浪線 〰️
兌換	兌換 💱
外匯	外匯 💱
換匯	換匯 💱
匯率	匯率 💱
流通	流通 💱
貨幣兌換	貨幣兌換 💱
出國	出國 💱
粗美元符號	粗美元符號 💲
貨幣	貨幣 💲
價錢	價錢 💲
醫療標誌	醫療標誌 ⚕
醫療符號	醫療符號 ⚕
蛇杖	蛇杖 ⚕
阿斯克勒庇俄斯	阿斯克勒庇俄斯 ⚕
單蛇之杖	單蛇之杖 ⚕
環保	環保 ♻️
循環	循環 ♻️
循環再生	循環再生 ♻️
循環利用	循環利用 ♻️
回收	回收 ♻️
百合花飾	百合花飾 ⚜️
百合花	百合花 ⚜️
鳶尾花	鳶尾花 ⚜️
三叉戟	三叉戟 🔱
三叉戟標誌	三叉戟標誌 🔱
姓名牌	姓名牌 📛
日本新手駕駛標誌	日本新手駕駛標誌 🔰
日本初學者標誌	日本初學者標誌 🔰
對	對 ⭕ ✅ ✔
答對	答對 ⭕ ✅
答對了	答對了 ⭕ ✅
正確	正確 ⭕ ✅ ✔
圓圈	圓圈 ⭕
對號	對號 ✅ ✔
對鉤	對鉤 ✅ ✔
按鈕	按鈕 ☑️ 🔘
勾選	勾選 ☑️ ✔
複選	複選 ☑️
複選框	複選框 ☑️
複選按鈕	複選按鈕 ☑️
打鉤	打鉤 ☑️
打對鉤	打對鉤 ☑️
錯	錯 ❌ ❎
答錯	答錯 ❌ ❎
答錯了	答錯了 ❌ ❎
錯號	錯號 ❌ ❎
錯誤	錯誤 ❌ ❎
叉	叉 ❌ ❎
叉叉	叉叉 ❌ ❎
畫叉	畫叉 ❌ ❎
捲曲環	捲曲環 ➰
雙捲曲環	雙捲曲環 ➿
歌記號	歌記號 〽️
八輪輻星號	八輪輻星號 ✳️
八角星	八角星 ✴️
版權	版權 ©
版權符號	版權符號 ©
Copyright	Copyright ©
註冊	註冊 ®
註冊標記	註冊標記 ®
註冊商標符號	註冊商標符號 ®
註冊商標	註冊商標 ®
Registered	Registered ®
商標	商標 ™
商標符號	商標符號 ™
TM	TM ™
井號	井號 #️⃣
井號鍵	井號鍵 #️⃣
星號	星號 *️⃣
星號鍵	星號鍵 *️⃣
零	零 0️⃣
一	一 1️⃣
二	二 2️⃣
三	三 3️⃣
四	四 4️⃣
五	五 5️⃣
六	六 6️⃣
七	七 7️⃣
八	八 8️⃣
九	九 9️⃣
十	十 🔟
ABCD	ABCD 🔠
英文	英文 🔠 🔡
英語	英語 🔠 🔡
拉丁文	拉丁文 🔠 🔡
大寫	大寫 🔠
英文大寫	英文大寫 🔠
大寫字母	大寫字母 🔠
abcd	abcd 🔡
小寫	小寫 🔡
英文小寫	英文小寫 🔡
小寫字母	小寫字母 🔡
數字	數字 🔢
一二三四	一二三四 🔢
符號	符號 🔣
字符	字符 🔣
abc	abc 🔤
血型	血型 🅰️ 🆎 🅱️ 🅾️
A	A 🅰️
A型	A型 🅰️
A型血	A型血 🅰️
A血型	A血型 🅰️
AB	AB 🆎
AB型	AB型 🆎
AB型血	AB型血 🆎
AB血型	AB血型 🆎
B	B 🅱️
B型	B型 🅱️
B型血	B型血 🅱️
B血型	B血型 🅱️
O	O 🅾️
O型	O型 🅾️
O型血	O型血 🅾️
O血型	O血型 🅾️
清除	清除 🆑
清理	清理 🆑
clear	clear 🆑
cool	cool 🆒
酷	酷 🆒
超酷	超酷 🆒
很酷	很酷 🆒
特別酷	特別酷 🆒
free	free 🆓
免費	免費 🆓
自由	自由 🆓
資訊	資訊 ℹ️
info	info ℹ️
information	information ℹ️
身份	身份 🆔
new	new 🆕
新	新 🆕
新的	新的 🆕
新建	新建 🆕
全新	全新 🆕
NG	NG 🆖
重拍	重拍 🆖
停車	停車 🅿️
停車場	停車場 🅿️
停車按鈕	停車按鈕 🅿️
泊車	泊車 🅿️
parking	parking 🅿️
SOS	SOS 🆘
求救信號	求救信號 🆘
求救訊號	求救訊號 🆘
救命	救命 🆘
救我	救我 🆘
救救我	救救我 🆘
求救	求救 🆘
up	up 🆙
頂	頂 🆙
升級	升級 🆙
Vs.	Vs. 🆚
比	比 🆚
對決	對決 🆚
對抗	對抗 🆚
對戰	對戰 🆚
比賽	比賽 🆚
這裡	這裡 🈁
服務費	服務費 🈂️
月	月 🈷️
有	有 🈶
有料	有料 🈶
收費	收費 🈶
指	指 🈯
得	得 🉐
討價還價	討價還價 🉐
割	割 🈹
打折	打折 🈹
無	無 🈚️
沒有	沒有 🈚️
禁	禁 🈲
可	可 🉑
申	申 🈸
申請	申請 🈸
合	合 🈴
合格	合格 🈴
空	空 🈳
空位	空位 🈳
祝	祝 ㊗️
祝福	祝福 ㊗️
秘	秘 ㊙️
營	營 🈺
營業	營業 🈺
開門營業	開門營業 🈺
滿	滿 🈵
滿座	滿座 🈵
滿了	滿了 🈵
沒有空位	沒有空位 🈵
紅色	紅色 🔴 🟥
橙色	橙色 🟠 🟧
橘色	橘色 🟠 🟧
橘黃色	橘黃色 🟠 🟧
黃色	黃色 🟡 🟨
綠色	綠色 🟢 🟩
藍色	藍色 🔵 🟦
紫色	紫色 🟣 🟪
棕色	棕色 🟤 🟫
圓形	圓形 ⚫ ⚪
圍棋	圍棋 ⚫ ⚪
黑白棋	黑白棋 ⚫ ⚪
黑色	黑色 ⚫ ⬛
黑子	黑子 ⚫
黑棋	黑棋 ⚫
黑點	黑點 ⚫
小黑點	小黑點 ⚫
小黑點兒	小黑點兒 ⚫
白色	白色 ⚪ ⬜
白子	白子 ⚪
白棋	白棋 ⚪
白點	白點 ⚪
小白點	小白點 ⚪
小白點兒	小白點兒 ⚪
元宵	元宵 ⚪
湯圓	湯圓 ⚪
雪球	雪球 ⚪
小圓點	小圓點 ⚪
小圓點兒	小圓點兒 ⚪
正方形	正方形 ⬛ ⬜
方塊	方塊 ⬛ ⬜
方形	方形 ⬛ ⬜
矩形	矩形 ⬛ ⬜
黑框	黑框 ⬛
小黑框	小黑框 ⬛
白框	白框 ⬜
小白框	小白框 ⬜
中方塊	中方塊 ◼ ◻
中正方形	中正方形 ◼ ◻
白色中方塊	白色中方塊 ◼
中等方塊	中等方塊 ◼ ◻
中等正方形	中等正方形 ◼ ◻
白色中等方塊	白色中等方塊 ◼
黑色中方塊	黑色中方塊 ◻
黑色中等方塊	黑色中等方塊 ◻
大方塊	大方塊 ◾ ◽
大正方形	大正方形 ◾ ◽
白色大方塊	白色大方塊 ◾
黑色大方塊	黑色大方塊 ◽
小方塊	小方塊 ▪ ▫
小正方形	小正方形 ▪ ▫
白色小方塊	白色小方塊 ▪
黑色小方塊	黑色小方塊 ▫
菱形	菱形 🔶 🔷
大菱形	大菱形 🔶 🔷
橙色菱形	橙色菱形 🔶
橘色菱形	橘色菱形 🔶
橘黃色菱形	橘黃色菱形 🔶
橙色大菱形	橙色大菱形 🔶
橘色大菱形	橘色大菱形 🔶
橘黃色大菱形	橘黃色大菱形 🔶
藍色菱形	藍色菱形 🔷
藍色大菱形	藍色大菱形 🔷
小方片	小方片 🔸 🔹
小菱形	小菱形 🔸 🔹
橙色小菱形	橙色小菱形 🔸
橘色小菱形	橘色小菱形 🔸
橘黃色小菱形	橘黃色小菱形 🔸
藍色小菱形	藍色小菱形 🔹
三角	三角 🔺 🔻
三角形	三角形 🔺 🔻
正三角	正三角 🔺
紅色正三角	紅色正三角 🔺
倒三角	倒三角 🔻
紅色倒三角	紅色倒三角 🔻
單選	單選 🔘
單選框	單選框 🔘
單選按鈕	單選按鈕 🔘
方形按鈕	方形按鈕 🔳 🔲
白線方形按鈕	白線方形按鈕 🔳
白線正方形按鈕	白線正方形按鈕 🔳
白色方形按鈕	白色方形按鈕 🔳
白色正方形按鈕	白色正方形按鈕 🔳
白邊線方形按鈕	白邊線方形按鈕 🔳
白邊線正方形按鈕	白邊線正方形按鈕 🔳
黑線方形按鈕	黑線方形按鈕 🔲
黑線正方形按鈕	黑線正方形按鈕 🔲
黑色方形按鈕	黑色方形按鈕 🔲
黑色正方形按鈕	黑色正方形按鈕 🔲
黑邊線方形按鈕	黑邊線方形按鈕 🔲
黑邊線正方形按鈕	黑邊線正方形按鈕 🔲
格子旗	格子旗 🏁
終點旗	終點旗 🏁
終點	終點 🏁
旗幟	旗幟 🏁 🚩 🎌 🏴 🏳 🏳️‍🌈 🏳️‍⚧️ 🏴‍☠️
旗子	旗子 🏁 🚩 🎌 🏴 🏳 🏳️‍🌈 🏳️‍⚧️ 🏴‍☠️
紅旗	紅旗 🚩
旗	旗 🏁 🚩 🎌 🏴 🏳 🏳️‍🌈 🏳️‍⚧️ 🏴‍☠️
投降	投降 🏳️ ┗(T﹏T)┛
彩虹旗	彩虹旗 🏳️‍🌈
異性	異性 ⚤ 💏 👫 💏
同性	同性 ⚢ ⚣ 🏳️‍🌈 👬 👭 👨‍❤️‍👨 👩‍❤️‍👩 👨‍❤️‍💋‍👨 👩‍❤️‍💋‍👩
異性戀	異性戀 ⚤ 💏 👫 💏
三角旗	三角旗 🚩
旗杆上的三角旗	旗杆上的三角旗 🚩
旗杆上的旗幟	旗杆上的旗幟 🚩
紅色旗幟	紅色旗幟 🚩
交叉旗	交叉旗 🎌
舉黑旗	舉黑旗 🏴
黑旗	黑旗 🏴
黑色旗	黑色旗 🏴
黑色旗子	黑色旗子 🏴
黑色旗幟	黑色旗幟 🏴
舉白旗	舉白旗 🏳
白旗	白旗 🏳
白色旗子	白色旗子 🏳
白色旗幟	白色旗幟 🏳
認輸	認輸 🏳
認輸了	認輸了 🏳
同性旗	同性旗 🏳️‍🌈
跨性別旗	跨性別旗 🏳️‍⚧️
海盜	海盜 🏴‍☠️
海盜旗	海盜旗 🏴‍☠️
海賊	海賊 🏴‍☠️
海賊旗	海賊旗 🏴‍☠️
阿森松島	阿森松島 🇦🇨
Ascension	Ascension 🇦🇨
安道爾	安道爾 🇦🇩
Andorra	Andorra 🇦🇩
阿拉伯聯合酋長國	阿拉伯聯合酋長國 🇦🇪
Arab	Arab 🇦🇪
阿富汗	阿富汗 🇦🇫
Afghanistan	Afghanistan 🇦🇫
安提瓜和巴布達	安提瓜和巴布達 🇦🇬
Antigua	Antigua 🇦🇬
Barbuda	Barbuda 🇦🇬
安圭拉島	安圭拉島 🇦🇮
Anguilla	Anguilla 🇦🇮
阿爾巴尼亞	阿爾巴尼亞 🇦🇱
Albania	Albania 🇦🇱
亞美尼亞	亞美尼亞 🇦🇲
Armenia	Armenia 🇦🇲
安哥拉	安哥拉 🇦🇴
Angola	Angola 🇦🇴
南極洲	南極洲 🇦🇶
Antarctica	Antarctica 🇦🇶
阿根廷	阿根廷 🇦🇷
Argentina	Argentina 🇦🇷
奧地利	奧地利 🇦🇹
Austria	Austria 🇦🇹
澳大利亞	澳大利亞 🇦🇺
Australia	Australia 🇦🇺
阿魯巴島	阿魯巴島 🇦🇼
Aruba	Aruba 🇦🇼
阿蘭群島	阿蘭群島 🇦🇽
Åland	Åland 🇦🇽
阿塞拜疆	阿塞拜疆 🇦🇿
Azerbaijan	Azerbaijan 🇦🇿
波斯尼亞和黑塞哥維那	波斯尼亞和黑塞哥維那 🇧🇦
Bosnia	Bosnia 🇧🇦
Herzegovina	Herzegovina 🇧🇦
巴巴多斯	巴巴多斯 🇧🇧
Barbados	Barbados 🇧🇧
孟加拉	孟加拉 🇧🇩
Bangladesh	Bangladesh 🇧🇩
比利時	比利時 🇧🇪
Belgium	Belgium 🇧🇪
布基納法索	布基納法索 🇧🇫
BurkinaFaso	BurkinaFaso 🇧🇫
保加利亞	保加利亞 🇧🇬
Bulgaria	Bulgaria 🇧🇬
巴林	巴林 🇧🇭
Bahrain	Bahrain 🇧🇭
布隆迪	布隆迪 🇧🇮
Burundi	Burundi 🇧🇮
貝寧	貝寧 🇧🇯
Benin	Benin 🇧🇯
百慕大	百慕大 🇧🇲
Bermuda	Bermuda 🇧🇲
文萊	文萊 🇧🇳
Brunei	Brunei 🇧🇳
玻利維亞	玻利維亞 🇧🇴
Bolivia	Bolivia 🇧🇴
加勒比	加勒比 🇧🇶
Caribbean	Caribbean 🇧🇶
巴西	巴西 🇧🇷
Brazil	Brazil 🇧🇷
巴哈馬	巴哈馬 🇧🇸
Bahamas	Bahamas 🇧🇸
不丹	不丹 🇧🇹
Bhutan	Bhutan 🇧🇹
布維島	布維島 🇧🇻
Bouvet	Bouvet 🇧🇻
博茨瓦納	博茨瓦納 🇧🇼
Botswana	Botswana 🇧🇼
白俄羅斯	白俄羅斯 🇧🇾
Belarus	Belarus 🇧🇾
伯利茲	伯利茲 🇧🇿
Belize	Belize 🇧🇿
加拿大	加拿大 🇨🇦
Canada	Canada 🇨🇦
湯加	湯加 🇹🇴
Tonga	Tonga 🇹🇴
科科斯	科科斯 🇨🇨
Cocos	Cocos 🇨🇨
剛果	剛果 🇨🇩 🇨🇬
Congo	Congo 🇨🇩 🇨🇬
中非共和國	中非共和國 🇨🇫
African	African 🇨🇫
瑞士	瑞士 🇨🇭
Switzerland	Switzerland 🇨🇭
科特迪瓦	科特迪瓦 🇨🇮
庫克群島	庫克群島 🇨🇰
Cook	Cook 🇨🇰
智利	智利 🇨🇱
Chile	Chile 🇨🇱
喀麥隆	喀麥隆 🇨🇲
Cameroon	Cameroon 🇨🇲
中國	中國 🇨🇳 中華人民共和國
中華人民共和國	中華人民共和國 🇨🇳
China	China 🇨🇳
哥倫比亞	哥倫比亞 🇨🇴
Colombia	Colombia 🇨🇴
克利珀頓	克利珀頓 🇨🇵
Clipperton	Clipperton 🇨🇵
哥斯達黎加	哥斯達黎加 🇨🇷
古巴	古巴 🇨🇺
Cuba	Cuba 🇨🇺
佛得角	佛得角 🇨🇻
庫拉索	庫拉索 🇨🇼
Curaçao	Curaçao 🇨🇼
聖誕島	聖誕島 🇨🇽
Christmas	Christmas 🇨🇽
塞浦路斯	塞浦路斯 🇨🇾
Cyprus	Cyprus 🇨🇾
捷克	捷克 🇨🇿
Czech	Czech 🇨🇿
德國	德國 🇩🇪 德意志聯邦共和國
Germany	Germany 🇩🇪
迪戈加西亞島	迪戈加西亞島 🇩🇬
吉布提	吉布提 🇩🇯
Djibouti	Djibouti 🇩🇯
丹麥	丹麥 🇩🇰
Denmark	Denmark 🇩🇰
多米尼加	多米尼加 🇩🇲 🇩🇴
Dominica	Dominica 🇩🇲 🇩🇴
阿爾及利亞	阿爾及利亞 🇩🇿
Algeria	Algeria 🇩🇿
休達	休達 🇪🇦
梅利利亞	梅利利亞 🇪🇦
Ceuta	Ceuta 🇪🇦
Melilla	Melilla 🇪🇦
厄瓜多爾	厄瓜多爾 🇪🇨
Ecuador	Ecuador 🇪🇨
愛沙尼亞	愛沙尼亞 🇪🇪
Estonia	Estonia 🇪🇪
埃及	埃及 🇪🇬
Egypt	Egypt 🇪🇬
撒哈拉	撒哈拉 🇪🇭
Sahara	Sahara 🇪🇭
厄立特里亞	厄立特里亞 🇪🇷
Eritrea	Eritrea 🇪🇷
西班牙	西班牙 🇪🇸
Spain	Spain 🇪🇸
埃塞俄比亞	埃塞俄比亞 🇪🇹
Ethiopia	Ethiopia 🇪🇹
歐盟	歐盟 🇪🇺
芬蘭	芬蘭 🇫🇮
Finland	Finland 🇫🇮
斐濟	斐濟 🇫🇯
Fiji	Fiji 🇫🇯
福克蘭群島	福克蘭群島 🇫🇰
Falkland	Falkland 🇫🇰
密克羅尼西亞	密克羅尼西亞 🇫🇲
法羅群島	法羅群島 🇫🇴
Faroe	Faroe 🇫🇴
法國	法國 🇫🇷 法蘭西共和國
France	France 🇫🇷
加蓬	加蓬 🇬🇦
Gabon	Gabon 🇬🇦
英國	英國 🇬🇧 大不列顛及北愛爾蘭聯合王國
格林納達	格林納達 🇬🇩
Grenada	Grenada 🇬🇩
格魯吉亞	格魯吉亞 🇬🇪
Georgia	Georgia 🇬🇪
加納	加納 🇬🇭
Ghana	Ghana 🇬🇭
直布羅陀	直布羅陀 🇬🇮
Gibraltar	Gibraltar 🇬🇮
格陵蘭	格陵蘭 🇬🇱
Greenland	Greenland 🇬🇱
岡比亞	岡比亞 🇬🇲
Gambia	Gambia 🇬🇲
幾內亞	幾內亞 🇬🇳
Guinea	Guinea 🇬🇳
赤道幾內亞	赤道幾內亞 🇬🇶
希臘	希臘 🇬🇷 αalpha βbeta γgamma δdelta εepsilon ζzeta ηeta θtheta ιiota κkappa λlambda μmu νnu ξxi οomicron πpi ρrho σsigma τtau υupsilon φphi χchi ψpsi ωomega Αalpha Βbeta Γgamma Δdelta Εepsilon Ζzeta Ηeta Θtheta Ιiota Κkappa Λlambda Μmu Νnu Ξxi Οomicron Πpi Ρrho Σsigma Τtau Υupsilon Φphi Χchi Ψpsi Ωomega
Greece	Greece 🇬🇷
危地馬拉	危地馬拉 🇬🇹
Guatemala	Guatemala 🇬🇹
關島	關島 🇬🇺
Guam	Guam 🇬🇺
幾內亞比紹	幾內亞比紹 🇬🇼
香港	香港 🇭🇰
洪都拉斯	洪都拉斯 🇭🇳
Honduras	Honduras 🇭🇳
克羅地亞	克羅地亞 🇭🇷
Croatia	Croatia 🇭🇷
海地	海地 🇭🇹
Haiti	Haiti 🇭🇹
匈牙利	匈牙利 🇭🇺
Hungary	Hungary 🇭🇺
印度尼西亞	印度尼西亞 🇮🇩
Indonesia	Indonesia 🇮🇩
愛爾蘭	愛爾蘭 🇮🇪
Ireland	Ireland 🇮🇪
以色列	以色列 🇮🇱
Israel	Israel 🇮🇱
印度	印度 🇮🇳
India	India 🇮🇳
伊拉克	伊拉克 🇮🇶
Iraq	Iraq 🇮🇶
伊朗	伊朗 🇮🇷
Iran	Iran 🇮🇷
冰島	冰島 🇮🇸
Iceland	Iceland 🇮🇸
意大利	意大利 🇮🇹
Italy	Italy 🇮🇹
牙買加	牙買加 🇯🇲
Jamaica	Jamaica 🇯🇲
約旦	約旦 🇯🇴
Jordan	Jordan 🇯🇴
日本	日本 🇯🇵 🗾 🎌 ㍻ ㍼ ㍽ ㍾ ㋿ ㍿
Japan	Japan 🇯🇵 🗾 🎌
肯尼亞	肯尼亞 🇰🇪
Kenya	Kenya 🇰🇪
吉爾吉斯斯坦	吉爾吉斯斯坦 🇰🇬
Kyrgyzstan	Kyrgyzstan 🇰🇬
柬埔寨	柬埔寨 🇰🇭
Cambodia	Cambodia 🇰🇭
基里巴斯	基里巴斯 🇰🇮
Kiribati	Kiribati 🇰🇮
朝鮮	朝鮮 🇰🇵
韓國	韓國 🇰🇷
Korea	Korea 🇰🇵 🇰🇷
科威特	科威特 🇰🇼
Kuwait	Kuwait 🇰🇼
哈薩克斯坦	哈薩克斯坦 🇰🇿
Kazakhstan	Kazakhstan 🇰🇿
老撾	老撾 🇱🇦
黎巴嫩	黎巴嫩 🇱🇧
Lebanon	Lebanon 🇱🇧
列支敦士登	列支敦士登 🇱🇮
Liechtenstein	Liechtenstein 🇱🇮
利比里亞	利比里亞 🇱🇷
Liberia	Liberia 🇱🇷
萊索托	萊索托 🇱🇸
Lesotho	Lesotho 🇱🇸
立陶宛	立陶宛 🇱🇹
Lithuania	Lithuania 🇱🇹
盧森堡	盧森堡 🇱🇺
Luxemburg	Luxemburg 🇱🇺
拉脫維亞	拉脫維亞 🇱🇻
Latvia	Latvia 🇱🇻
利比亞	利比亞 🇱🇾
Libya	Libya 🇱🇾
摩洛哥	摩洛哥 🇲🇦
Morocco	Morocco 🇲🇦
摩納哥	摩納哥 🇲🇨
Monaco	Monaco 🇲🇨
摩爾多瓦	摩爾多瓦 🇲🇩
Moldova	Moldova 🇲🇩
黑山	黑山 🇲🇪
Montenegro	Montenegro 🇲🇪
馬達加斯加	馬達加斯加 🇲🇬
Madagascar	Madagascar 🇲🇬
馬其頓	馬其頓 🇲🇰
Macedonia	Macedonia 🇲🇰
馬裡	馬裡 🇲🇱
Mali	Mali 🇲🇱
緬甸	緬甸 🇲🇲
Myanmar	Myanmar 🇲🇲
蒙古	蒙古 🇲🇳
Mongolia	Mongolia 🇲🇳
澳門	澳門 🇲🇴
Macau	Macau 🇲🇴
毛里塔尼亞	毛里塔尼亞 🇲🇷
Mauritania	Mauritania 🇲🇷
馬耳他	馬耳他 🇲🇹
Malta	Malta 🇲🇹
毛里求斯	毛里求斯 🇲🇺
Mauritius	Mauritius 🇲🇺
馬爾代夫	馬爾代夫 🇲🇻
Maldives	Maldives 🇲🇻
馬拉維	馬拉維 🇲🇼
Malawi	Malawi 🇲🇼
墨西哥	墨西哥 🇲🇽
Mexico	Mexico 🇲🇽
馬來西亞	馬來西亞 🇲🇾
Malaysia	Malaysia 🇲🇾
莫桑比克	莫桑比克 🇲🇿
Mozambique	Mozambique 🇲🇿
納米比亞	納米比亞 🇳🇦
Namibia	Namibia 🇳🇦
尼日爾	尼日爾 🇳🇪
Niger	Niger 🇳🇪
尼日利亞	尼日利亞 🇳🇬
Nigeria	Nigeria 🇳🇬
尼加拉瓜	尼加拉瓜 🇳🇮
Nicaragua	Nicaragua 🇳🇮
荷蘭	荷蘭 🇳🇱
Netherlands	Netherlands 🇳🇱
挪威	挪威 🇳🇴
Norway	Norway 🇳🇴
尼泊爾	尼泊爾 🇳🇵
Nepal	Nepal 🇳🇵
瑙魯	瑙魯 🇳🇷
Nauru	Nauru 🇳🇷
新西蘭	新西蘭 🇳🇿
阿曼	阿曼 🇴🇲
Oman	Oman 🇴🇲
巴拿馬	巴拿馬 🇵🇦
Panama	Panama 🇵🇦
秘魯	秘魯 🇵🇪
Peru	Peru 🇵🇪
菲律賓	菲律賓 🇵🇭
Philippines	Philippines 🇵🇭
巴基斯坦	巴基斯坦 🇵🇰
Pakistan	Pakistan 🇵🇰
波蘭	波蘭 🇵🇱
Poland	Poland 🇵🇱
葡萄牙	葡萄牙 🇵🇹
Portugal	Portugal 🇵🇹
巴拉圭	巴拉圭 🇵🇾
Paraguay	Paraguay 🇵🇾
卡塔爾	卡塔爾 🇶🇦
Qatar	Qatar 🇶🇦
羅馬尼亞	羅馬尼亞 🇷🇴
Romania	Romania 🇷🇴
塞爾維亞	塞爾維亞 🇷🇸
Serbia	Serbia 🇷🇸
俄羅斯	俄羅斯 🇷🇺
Russia	Russia 🇷🇺
俄國	俄國 🇷🇺
盧旺達	盧旺達 🇷🇼
Rwanda	Rwanda 🇷🇼
蘇丹	蘇丹 🇸🇩
Sudan	Sudan 🇸🇩
瑞典	瑞典 🇸🇪
Sweden	Sweden 🇸🇪
新加坡	新加坡 🇸🇬
Singapore	Singapore 🇸🇬
斯洛文尼亞	斯洛文尼亞 🇸🇮
Slovenia	Slovenia 🇸🇮
斯洛伐克	斯洛伐克 🇸🇰
Slovakia	Slovakia 🇸🇰
塞內加爾	塞內加爾 🇸🇳
Senegal	senegal 🇸🇳
索馬里	索馬里 🇸🇴
Somalia	Somalia 🇸🇴
敘利亞	敘利亞 🇸🇾
Syria	Syria 🇸🇾
斯威士蘭	斯威士蘭 🇸🇿
Swaziland	Swaziland 🇸🇿
乍得	乍得 🇹🇩
Chad	Chad 🇹🇩
多哥	多哥 🇹🇬
Togo	Togo 🇹🇬
泰國	泰國 🇹🇭
Thailand	Thailand 🇹🇭
東帝汶	東帝汶 🇹🇱
塔吉克斯坦	塔吉克斯坦 🇹🇯
Tajikistan	Tajikistan 🇹🇯
土庫曼斯坦	土庫曼斯坦 🇹🇲
Turkmenistan	Turkmenistan 🇹🇲
突尼斯	突尼斯 🇹🇳
Tunisia	Tunisia 🇹🇳
土耳其	土耳其 🇹🇷
Turkey	Turkey 🇹🇷
臺灣	臺灣 🇹🇼
坦桑尼亞	坦桑尼亞 🇹🇿
Tanzania	Tanzania 🇹🇿
烏克蘭	烏克蘭 🇺🇦
Ukraine	Ukraine 🇺🇦
烏干達	烏干達 🇺🇬
Uganda	Uganda 🇺🇬
聯合國	聯合國 🇺🇳
美國	美國 🇺🇸 美利堅合眾國
烏拉圭	烏拉圭 🇺🇾
Uruguay	Uruguay 🇺🇾
烏茲別克斯坦	烏茲別克斯坦 🇺🇿
Uzbekistan	Uzbekistan 🇺🇿
梵蒂岡	梵蒂岡 🇻🇦
Vatican	Vatican 🇻🇦
委內瑞拉	委內瑞拉 🇻🇪
Venezuela	Venezuela 🇻🇪
越南	越南 🇻🇳
Vietnam	Vietnam 🇻🇳
薩摩亞	薩摩亞 🇼🇸
Samoa	Samoa 🇼🇸
科索沃	科索沃 🇽🇰
Kosovo	Kosovo 🇽🇰
也門	也門 🇾🇪
Yemen	Yemen 🇾🇪
南非	南非 🇿🇦
贊比亞	贊比亞 🇿🇲
Zambia	Zambia 🇿🇲
津巴布韋	津巴布韋 🇿🇼
Zimbabwe	Zimbabwe 🇿🇼
英格蘭	英格蘭 🏴󠁧󠁢󠁥󠁮󠁧󠁿
蘇格蘭	蘇格蘭 🏴󠁧󠁢󠁳󠁣󠁴󠁿
威爾士	威爾士 🏴󠁧󠁢󠁷󠁬󠁳󠁿
阿爾法	阿爾法 alpha α Α
貝塔	貝塔 beta β Β
伽馬	伽馬 gamma γ Γ
德爾塔	德爾塔 delta δ Δ
艾普西隆	艾普西隆 epsilon ε Ε
澤塔	澤塔 zeta ζ Ζ
伊塔	伊塔 eta η Η
西塔	西塔 theta θ Θ
約塔	約塔 iota ι Ι
卡帕	卡帕 kappa κ Κ
拉姆達	拉姆達 lambda λ Λ
克西	克西 ξ Ξ
奧密克戎	奧密克戎 omicron ο Ο
西格馬	西格馬 sigma σ/ς Σ
宇普西隆	宇普西隆 upsilon υ Υ
普西	普西 psi ψ Ψ
奧米伽	奧米伽 omega ω Ω
Twitter	Twitter 𝕏
推特	推特 𝕏
阿爾法粒子	阿爾法粒子 α粒子
阿爾法射線	阿爾法射線 α射線
貝塔粒子	貝塔粒子 β粒子
貝塔射線	貝塔射線 β射線
伽馬刀	伽馬刀 γ刀
伽馬射線	伽馬射線 γ射線
rime	rime 㞢
中州韻	中州韻 Rime
鼠須管	鼠須管 Squirrel
小狼毫	小狼毫 Weasel
倉輸入法	倉輸入法 Hamster
hbar	hbar ℏ ħ
aleph	aleph א
alpha	alpha Α 𝛢 α 𝛼
beta	beta Β 𝛣 β 𝛽
gamma	gamma Γ 𝛤 γ 𝛾
delta	delta Δ 𝛥 δ 𝛿
epsilon	epsilon Ε 𝛦 ε 𝜀 ϵ 𝜖
zeta	zeta Ζ 𝛧 ζ 𝜁
eta	eta Η 𝛨 η 𝜂
theta	theta Θ 𝛩 ϴ 𝛳 θ 𝜃 ϑ 𝜗
iota	iota Ι 𝛪 ι 𝜄
kappa	kappa Κ 𝛫 κ 𝜅 ϰ 𝜘
lambda	lambda Λ 𝛬 λ 𝜆
xi	xi Ξ 𝛯 ξ 𝜉
omicron	omicron Ο 𝛰 ο 𝜊
rho	rho Ρ 𝛲 ρ 𝜌 ϱ 𝜚
sigma	sigma Σ 𝛴 σ 𝜎
tau	tau Τ 𝛵 τ 𝜏
upsilon	upsilon Υ 𝛶 υ 𝜐
phi	phi Φ 𝛷 φ 𝜑 ϕ 𝜙
psi	psi Ψ 𝛹 ψ 𝜓
omega	omega Ω 𝛺 ω 𝜔
釐	釐 ㌢
質量	質量 ㎍ ㎎ ㎏
克	克 ㎍ ㎎ ㎏ ㌘
噸	噸 ㌧
距離	距離 ㎙ ㎚ ㎛ ㎜ ㎝ ㎞
長度	長度 ㎙ ㎚ ㎛ ㎜ ㎝ ㎞
米	米 ㎙ ㎚ ㎛ ㎜ ㎝ ㎞ ㍍
弧度	弧度 ㎭ ㎮ ㎯
面積	面積 ㎟ ㎠ ㎡ ㎢
公頃	公頃 ㌶
體積	體積 ㎣ ㎤ ㎥ ㎦ ㎕ ㎖ ㎗ ㎘ ㍑
電流	電流 ㎀ ㎁ ㎂ ㎃ ㎄
安	安 🉃 ㎀ ㎁ ㎂ ㎃ ㎄
安培	安培 ㎀ ㎁ ㎂ ㎃ ㎄
容量	容量 ㎕ ㎖ ㎗ ㎘
升	升 ㎕ ㎖ ㎗ ㎘ ㍑
頻率	頻率 ㎐ ㎑ ㎒ ㎓ ㎔
赫茲	赫茲 ㎐ ㎑ ㎒ ㎓ ㎔
速度	速度 ㎧
加速度	加速度 ㎨
壓強	壓強 ㎩ ㍱ ㎪ ㎫ ㎬
壓力	壓力 ㎩ ㍱ ㎪ ㎫ ㎬
帕	帕 ㎩ ㍱ ㎪ ㎫ ㎬
帕斯卡	帕斯卡 ㎩ ㍱ ㎪ ㎫ ㎬
電壓	電壓 ㎴ ㎵ ㎶ ㎷ ㎸ ㎹
伏	伏 ㎴ ㎵ ㎶ ㎷ ㎸ ㎹
伏特	伏特 ㎴ ㎵ ㎶ ㎷ ㎸ ㎹
功率	功率 ㎺ ㎻ ㎼ ㎽ ㎾ ㎿
瓦	瓦 ㎺ ㎻ ㎼ ㎽ ㎾ ㎿ ㍗
瓦特	瓦特 ㎺ ㎻ ㎼ ㎽ ㎾ ㎿ ㍗
電阻	電阻 ㏀ ㏁
歐	歐 ㏀ ㏁
歐姆	歐姆 ㏀ ㏁
電容	電容 ㎊ ㎋ ㎌
法拉	法拉 ㎊ ㎋ ㎌
字節	字節 ㎅ ㎆ ㎇
對數	對數 ㏑ ㏒
摩爾	摩爾 ㏖
ppm	ppm ㏙
分貝	分貝 ㏈
平方米	平方米 ㎡
英里	英里 ㏕
納米	納米 ㎚
微米	微米 ㎛
毫米	毫米 ㎜
釐米	釐米 ㎝
千米	千米 ㎞ ㏎
立方米	立方米 m³
毫克	毫克 ㎎
千克	千克 ㎏
積分	積分 ∫ ∬ ∭ ∮ ∯ ∰ ⨌
七情	七情 喜 怒 憂 思 悲 恐 驚
六慾	六慾 眼（見欲，貪美色奇物） 耳（聽欲，貪美音贊言） 鼻（香欲，貪香味） 舌（味欲，貪美食口快） 身（觸欲，貪舒適享受） 意（意欲，貪聲色、名利、恩愛） 色慾 形貌欲 威儀姿態欲 言語音聲欲 細滑欲和人相欲
天干	天干 甲 乙 丙 丁 戊 己 庚 辛 壬 癸
地支	地支 子 醜 寅 卯 辰 巳 午 未 申 酉 戌 亥
干支	干支 甲子 乙丑 丙寅 丁卯 戊辰 己巳 庚午 辛未 壬申 癸酉 甲戌 乙亥 丙子 丁丑 戊寅 己卯 庚辰 辛巳 壬午 癸未 甲申 乙酉 丙戌 丁亥 戊子 己丑 庚寅 辛卯 壬辰 癸巳 甲午 乙未 丙申 丁酉 戊戌 己亥 庚子 辛丑 壬寅 癸卯 甲辰 乙巳 丙午 丁未 戊申 己酉 庚戌 辛亥 壬子 癸丑 甲寅 乙卯 丙辰 丁巳 戊午 己未 庚申 辛酉 壬戌 癸亥
節氣	節氣 冬至 小寒 大寒 立春 雨水 驚蟄 春分 清明 穀雨 立夏 小滿 芒種 夏至 小暑 大暑 立秋 處暑 白露 秋分 寒露 霜降 立冬 小雪 大雪
五穀	五穀 稻 黍（黍米） 稷（小米） 麥 菽（大豆） 麻（大麻）
三字經	三字經 人之初 性本善 性相近 習相遠 苟不教 性乃遷 教之道 貴以專 昔孟母 擇鄰處 子不學 斷機杼 竇燕山 有義方 教五子 名俱揚 養不教 父之過 教不嚴 師之惰 子不學 非所宜 幼不學 老何為 玉不琢 不成器 人不學 不知義 為人子 方少時 親師友 習禮儀 香九齡 能溫席 孝於親 所當執 融四歲 能讓梨 弟於長 宜先知 首孝弟 次見聞 知某數 識某文 一而十 十而百 百而千 千而萬 三才者 天地人 三光者 日月星 三綱者 君臣義 父子親 夫婦順 曰春夏 曰秋冬 此四時 運不窮 曰南北 曰西東 此四方 應乎中 曰水火 木金土 此五行 本乎數 曰仁義 禮智信 此五常 不容紊 稻粱菽 麥黍稷 此六穀 人所食 馬牛羊 雞犬豕 此六畜 人所飼 曰喜怒 曰哀懼 愛惡欲 七情具 匏土革 木石金 絲與竹 乃八音 高曾祖 父而身 身而子 子而孫 自子孫 至玄曾 乃九族 人之倫 父子恩 夫婦從 兄則友 弟則恭 長幼序 友與朋 君則敬 臣則忠 此十義 人所同 凡訓蒙 須講究 詳訓詁 明句讀 為學者 必有初 小學終 至四書 論語者 二十篇 群弟子 記善言 孟子者 七篇止 講道德 說仁義 作中庸 子思筆 中不偏 庸不易 作大學 乃曾子 自脩齊 至平治 孝經通 四書熟 如六經 始可讀 詩書易 禮春秋 號六經 當講求 有連山 有歸藏 有周易 三易詳 有典謨 有訓誥 有誓命 書之奧 我周公 作周禮 著六官 存治體 大小戴 注禮記 述聖言 禮樂備 曰國風 曰雅頌 號四詩 當諷詠 詩既亡 春秋作 寓褒貶 別善惡 三傳者 有公羊 有左氏 有穀梁 經既明 方讀子 撮其要 記其事 五子者 有荀楊 文中子 及老莊 經子通 讀諸史 考世系 知終始 自羲農 至黃帝 號三皇 居上世 唐有虞 號二帝 相揖遜 稱盛世 夏有禹 商有湯 周文武 稱三王 夏傳子 家天下 四百載 遷夏社 湯伐夏 國號商 六百載 至紂亡 周武王 始誅紂 八百載 最長久 周轍東 王綱墜 逞干戈 尚遊說 始春秋 終戰國 五霸強 七雄出 嬴秦氏 始兼併 傳二世 楚漢爭 高祖興 漢業建 至孝平 王莽篡 光武興 為東漢 四百年 終於獻 魏蜀吳 爭漢鼎 號三國 迄兩晉 宋齊繼 梁陳承 為南朝 都金陵 北元魏 分東西 宇文周 與高齊 迨至隋 一土宇 不再傳 失統緒 唐高祖 起義師 除隋亂 創國基 二十傳 三百載 梁滅之 國乃改 梁唐晉 及漢周 稱五代 皆有由 炎宋興 受周禪 十八傳 南北混 十七史 全在茲 載治亂 知興衰 讀史者 考實錄 通古今 若親目 口而誦 心而惟 朝於斯 夕於斯 昔仲尼 師項橐 古聖賢 尚勤學 趙中令 讀魯論 彼既仕 學且勤 披蒲編 削竹簡 彼無書 且知勉 頭懸樑 錐刺股 彼不教 自勤苦 如囊螢 如映雪 家雖貧 學不輟 如負薪 如掛角 身雖勞 猶苦卓 蘇老泉 二十七 始發憤 讀書籍 彼既老 猶悔遲 爾小生 宜早思 若梁灝 八十二 對大廷 魁多士 彼既成 眾稱異 爾小生 宜立志 瑩八歲 能詠詩 泌七歲 能賦碁 彼穎悟 人稱奇 爾幼學 當效之 蔡文姬 能辨琴 謝道韞 能詠吟 彼女子 且聰敏 爾男子 當自警 唐劉晏 方七歲 舉神童 作正字 彼雖幼 身己仕 爾幼學 勉而致 有為者 亦若是 犬守夜 雞司晨 苟不學 曷為人 蠶吐絲 蜂釀蜜 人不學 不如物 幼而學 壯而行 上致君 下澤民 揚名聲 顯父母 光於前 裕於後 人遺子 金滿籯 我教子 惟一經 勤有功 戲無益 戒之哉 宜勉力
百家姓	百家姓 趙錢孫李 周吳鄭王 馮陳褚衛 蔣沈韓楊 朱秦尤許 何呂施張 孔曹嚴華 金魏陶姜 戚謝鄒喻 柏水竇章 雲蘇潘葛 奚範彭郎 魯韋昌馬 苗鳳花方 俞任袁柳 酆鮑史唐 費廉岑薛 雷賀倪湯 滕殷羅畢 郝鄔安常 樂於時傅 皮卞齊康 伍餘元卜 顧孟平黃 和穆蕭尹 姚邵湛汪 祁毛禹狄 米貝明臧 計伏成戴 談宋茅龐 熊紀舒屈 項祝董梁 杜阮藍閔 席季麻強 賈路婁危 江童顏郭 梅盛林刁 鍾徐邱駱 高夏蔡田 樊胡凌霍 虞萬支柯 昝管盧莫 經房裘繆 幹解應宗 丁宣賁鄧 鬱單杭洪 包諸左石 崔吉鈕龔 程嵇邢滑 裴陸榮翁 荀羊於惠 甄曲家封 芮羿儲靳 汲邴糜松 井段富巫 烏焦巴弓 牧隗山谷 車侯宓蓬 全郗班仰 秋仲伊宮 寧仇欒暴 甘鈄厲戎 祖武符劉 景詹束龍 葉幸司韶 郜黎薊薄 印宿白懷 蒲邰從鄂 索鹹籍賴 卓藺屠蒙 池喬陰鬱 胥能蒼雙 聞莘黨翟 譚貢勞逄 姬申扶堵 冉宰酈雍 卻璩桑桂 濮牛壽通 邊扈燕冀 郟浦尚農 溫別莊晏 柴瞿閻充 慕連茹習 宦艾魚容 向古易慎 戈廖庾終 暨居衡步 都耿滿弘 匡國文寇 廣祿闕東 歐殳沃利 蔚越夔隆 師鞏厙聶 晁勾敖融 冷訾辛闞 那簡饒空 曾毋沙乜 養鞠須豐 巢關蒯相 查後荊紅 遊竺權逯 蓋益桓公 万俟司馬 上官歐陽 夏侯諸葛 聞人東方 赫連皇甫 尉遲公羊 澹臺公冶 宗政濮陽 淳于單于 太叔申屠 公孫仲孫 軒轅令狐 鍾離宇文 長孫慕容 鮮于閭丘 司徒司空 丌官司寇 仉督子車 顓孫端木 巫馬公西 漆雕樂正 壤駟公良 拓跋夾谷 宰父穀梁 晉楚閆法 汝鄢塗欽 段幹百里 東郭南門 呼延歸海 羊舌微生 嶽帥緱亢 況郈有琴 梁丘左丘 東門西門 商牟佘佴 伯賞南宮 墨哈譙笪 年愛陽佟 第五言福 百家姓終
千字文	千字文 天地玄黃 宇宙洪荒 日月盈昃 辰宿列張 寒來暑往 秋收冬藏 閏餘成歲 律呂調陽 雲騰致雨 露結為霜 金生麗水 玉出昆崗 劍號巨闕 珠稱夜光 果珍李柰 菜重芥姜 海鹹河淡 鱗潛羽翔 龍師火帝 鳥官人皇 始制文字 乃服衣裳 推位讓國 有虞陶唐 弔民伐罪 周發殷湯 坐朝問道 垂拱平章 愛育黎首 臣伏戎羌 遐邇一體 帥賓歸王 鳴鳳在竹 白駒食場 化被草木 賴及萬方 蓋此身發 四大五常 恭惟鞠養 豈敢毀傷 女慕貞潔 男效才良 知過必改 得能莫忘 罔談彼短 靡恃己長 信使可復 器欲難量 墨悲絲染 詩讚羔羊 景行維賢 克唸作聖 德建名立 形端表正 空谷傳聲 虛堂習聽 禍因惡積 福緣善慶 尺璧非寶 寸陰是競 資父事君 曰嚴與敬 孝當竭力 忠則盡命 臨深履薄 夙興溫凊 似蘭斯馨 如松之盛 川流不息 淵澄取映 容止若思 言辭安定 篤初誠美 慎終宜令 榮業所基 籍甚無竟 學優登仕 攝職從政 存以甘棠 去而益詠 樂殊貴賤 禮別尊卑 上和下睦 夫唱婦隨 外受傅訓 入奉母儀 諸姑伯叔 猶子比兒 孔懷兄弟 同氣連枝 交友投分 切磨箴規 仁慈隱惻 造次弗離 節義廉退 顛沛匪虧 性靜情逸 心動神疲 守真志滿 逐物意移 堅持雅操 好爵自縻 都邑華夏 東西二京 背邙面洛 浮渭據涇 宮殿盤鬱 樓觀飛驚 圖寫禽獸 畫彩仙靈 丙舍旁啟 甲帳對楹 肆筵設席 鼓瑟吹笙 升階納陛 弁轉疑星 右通廣內 左達承明 既集墳典 亦聚群英 杜稿鍾隸 漆書壁經 府羅將相 路俠槐卿 戶封八縣 家給千兵 高冠陪輦 驅轂振纓 世祿侈富 車駕肥輕 策功茂實 勒碑刻銘 盤溪伊尹 佐時阿衡 奄宅曲阜 微旦孰營 桓公匡合 濟弱扶傾 綺回漢惠 說感武丁 俊乂密勿 多士是寧 晉楚更霸 趙魏困橫 假途滅虢 踐土會盟 何遵約法 韓弊煩刑 起翦頗牧 用兵最精 宣威沙漠 馳譽丹青 九州禹跡 百郡秦並 嶽宗泰岱 禪主雲亭 雁門紫塞 雞田赤城 昆池碣石 鉅野洞庭 曠遠綿邈 巖岫杳冥 治本於農 務資稼穡 俶載南畝 我藝黍稷 稅熟貢新 勸賞黜陟 孟軻敦素 史魚秉直 庶幾中庸 勞謙謹敕 聆音察理 鑑貌辨色 貽厥嘉猷 勉其祗植 省躬譏誡 寵增抗極 殆辱近恥 林皋幸即 兩疏見機 解組誰逼 索居閒處 沉默寂寥 求古訓論 散慮逍遙 欣奏累遣 戚謝歡招 渠荷的歷 園莽抽條 枇杷晚翠 梧桐蚤凋 陳根委翳 落葉飄搖 遊鵾獨運 凌摩絳霄 耽讀玩市 寓目囊箱 易輶攸畏 屬耳垣牆 具膳餐飯 適口充腸 飽飫烹宰 飢厭糟糠 親戚故舊 老少異糧 妾御績紡 侍巾帷房 紈扇圓潔 銀燭煒煌 晝眠夕寐 藍筍象床 絃歌酒宴 接杯舉觴 矯手頓足 悅豫且康 嫡後嗣續 祭祀烝嘗 稽顙再拜 悚懼恐慌 箋牒簡要 顧答審詳 骸垢想浴 執熱願涼 驢騾犢特 駭躍超驤 誅斬賊盜 捕獲叛亡 布射僚丸 嵇琴阮嘯 恬筆倫紙 鈞巧任釣 釋紛利俗 並皆佳妙 毛施淑姿 工顰妍笑 年矢每催 曦暉朗曜 旋即斡旋 晦魄環照 指薪修祜 永綏吉劭 矩步引領 俯仰廊廟 束帶矜莊 徘徊瞻眺 孤陋寡聞 愚蒙等誚 謂語助者 焉哉乎也
單位	單位 Å ℃ ％ ‰ ‱ ° ℉ ㏃ ㏆ ㎈ ㏄ ㏅ ㎝ ㎠ ㎤ ㏈ ㎗ ㎙ ㎓ ㎬ ㏉ ㏊ ㏋ ㎐ ㏌ ㎄ ㎅ ㎉ ㎏ ㎑ ㏍ ㎘ ㎞ ㏎ ㎢ ㎦ ㎪ ㏏ ㎸ ㎾ ㏀ ㏐ ㏓ ㎧ ㎨ ㎡ ㎥ ㎃ ㏔ ㎆ ㎎ ㎒ ㏕ ㎖ ㎜ ㎟ ㎣ ㏖ ㎫ ㎳ ㎷ ㎹ ㎽ ㎿ ㏁ ㎁ ㎋ ㎚ ㎱ ㎵ ㎻ ㏘ ㎩ ㎀ ㎊ ㏗ ㏙ ㏚ ㎰ ㎴ ㎺ ㎭ ㎮ ㎯ ㏛ ㏜ ㎔ ㏝ ㎂ ㎌ ㎍ ㎕ ㎛ ㎲ ㎶ ㎼
羅馬數字	羅馬數字 ⅰ ⅱ ⅲ ⅳ ⅴ ⅵ ⅶ ⅷ ⅸ ⅹ ⅺ ⅻ ⅼ ⅽ ⅾ ⅿ Ⅰ Ⅱ Ⅲ Ⅳ Ⅴ Ⅵ Ⅶ Ⅷ Ⅸ Ⅹ Ⅺ Ⅻ Ⅼ Ⅽ Ⅾ Ⅿ
上標	上標 ⁰ ¹ ² ³ ⁴ ⁵ ⁶ ⁷ ⁸ ⁹ ˜ ⁺ ⁻ ⁼ ⁽ ⁾ ᴬ ᵃ ᵄ ᵅ ᶛ ᴭ ᵆ ᴮ ᴯ ᵇ ᵝ ᶜ ᵓ ᶝ ᴰ ᵈ ᶞ ᵟ ᴱ ᵉ ᴲ ᵊ ᵋ ᶟ ᵌ ᶠ ᶡ ᶲ ᵠ ᴳ ᵍ ᶢ ˠ ᵞ ᴴ ʰ ᶣ ʱ ᴵ ⁱ ᶤ ᵎ ᶥ ᴶ ʲ ᶨ ᴷ ᵏ ᴸ ᶫ ˡ ᶩ ᶪ ᴹ ᵐ ᶬ ᵚ ᶭ ᴺ ᴻ ⁿ ᵑ ᶮ ᶯ ᴼ ᵒ ᶱ ᴽ ᴾ ᵖ ᴿ ʳ ʶ ʴ ʵ ˢ ᶴ ᶳ ᵀ ᵗ ᶵ ᶿ ᵁ ᵘ ᶶ ᶷ ᵙ ⱽ ᵛ ᶺ ᶹ ᵂ ʷ ˣ ᵡ ʸ ᶻ ᶾ ᶽ ᶼ
下標	下標 ₀ ₁ ₂ ₃ ₄ ₅ ₆ ₇ ₈ ₉ ₊ ₋ ₌ ₍ ₎ ‸ ᴀ ₐ ᴁ ʙ ᴃ ᵦ ᴄ ᴐ ᴒ ᴅ ᴆ ᴇ ₑ ₔ ᵩ ɢ ʛ ᴦ ᵧ ʜ ₕ ɪ ᵻ ᵢ ᴊ ⱼ ᴋ ₖ ʟ ₗ ᴌ ᴧ ᴍ ₘ ꟺ ɴ ᴎ ₙ ᴏ ₒ ɶ ʘ ᴓ ᴑ ᴘ ₚ ᴨ ᴪ ʀ ᵣ ᴙ ʁ ᴚ ᵨ ₛ ᴛ ₜ ᴜ ᵤ ᵾ ᴠ ᵥ ᴡ ₓ ᵪ ʏ ᴢ ᴣ
結構	結構 ⿰ ⿱ ⿲ ⿳ ⿴ ⿵ ⿶ ⿷ ⿸ ⿹ ⿺ ⿻ 〾
括號	括號 [] 〈〉 《》 ⁽⁾ ₍₎ 「」 『』 【】 〖〗 〔〕 ︵ ︶ ︷ ︸ ︹ ︺ ︻ ︼ ︽ ︾ ︿ ﹀ ﹁ ﹂ ﹃ ﹄ ﹙﹚ ﹛﹜ ﹝﹞ ﹤﹥ （） ＜＞ ｛｝
表	表 🕛 🕧 🕐 🕜 🕑 🕝 🕒 🕞 🕓 🕟 🕔 🕠 🕕 🕡 🕖 🕢 🕗 🕣 🕘 🕤 🕙 🕥 🕚 🕦 📈 📉 📊
鍾	鍾 🕛 🕧 🕐 🕜 🕑 🕝 🕒 🕞 🕓 🕟 🕔 🕠 🕕 🕡 🕖 🕢 🕗 🕣 🕘 🕤 🕙 🕥 🕚 🕦
鐘錶	鐘錶 🕛 🕧 🕐 🕜 🕑 🕝 🕒 🕞 🕓 🕟 🕔 🕠 🕕 🕡 🕖 🕢 🕗 🕣 🕘 🕤 🕙 🕥 🕚 🕦
統計	統計 📈 📉 📊
趨勢	趨勢 📈 📉 📊
pH	pH ㏗
比例	比例 4:3 16:9
標準	標準 ⊖ ⦵
定義	定義 ≔ ≝ ≕
分數	分數 ⁄ ½ ⅓ ⅔ ¼ ¾ ⅕ ⅖ ⅗ ⅘ ⅙ ⅚ ⅐ ⅛ ⅜ ⅝ ⅞ ⅑ ⅒ ⅟ ↉ ℀ ℁ ℅ ℆ ⅍
橫	橫 一
豎	豎 丨 |
撇	撇 丿
捺	捺 丶
折	折 乛 乚 亅
禮拜室	禮拜室 🛐
寺廟	寺廟 🛕
廟	廟 🛕
無窮	無窮 ♾️ ♾ ∞ +∞ -∞
無限	無限 ♾️ ♾ ∞
宗教	宗教 🕉 ✡ ☸ ✝ ☦ ☪ ☮ 🪬 🕎 🔯 ☯️ 🛐 🪯 ⛪️ 🕌 🕍 🕋 ⛩
八門	八門 開門 休門 生門 傷門 杜門 景門 死門 驚門
八卦	八卦 ☯ ☰ ☱ ☲ ☳ ☷ ☶ ☵ ☴ 天乾☰ 澤兌☱ 火離☲ 雷震☳ 地坤☷ 山艮☶ 水坎☵ 風巽☴
乾	乾 ☰
兌	兌 ☱
離	離 ☲
震	震 ☳
坤	坤 ☷
艮	艮 ☶
坎	坎 ☵
巽	巽 ☴
無線	無線 🛜
單曲	單曲 🔂
徽章	徽章 📛
共產黨	共產黨 ☭
黨	黨 ☭
共產主義	共產主義 ☭
國民黨	國民黨 ❂
戟	戟 🔱
勾	勾 ✔️ ✅ ☑ ✓ ✔ ⭕ √
新手	新手 🔰
對勾	對勾 ✔️ ✅ ☑ ✓ ✔ ⭕ √
確認	確認 ✅ ✔️
確定	確定 ✅ ✔️
偏	偏 ∂ 𝛛 𝜕 𝝏
partial	partial ∂ 𝛛 𝜕 𝝏
tm	tm Tm 銩 Thulium 69 169 ™
sm	sm Sm 釤 Samarium 62 150.5 ℠
根號	根號 √ ∛ ∜
nabla	nabla ∇
del	del ∇
atled	atled ∇
at	at @ At 砹 Astatine 85 210
和	和 & ∑ ∧
求和	求和 ∑
加減	加減 ± ∓
正負	正負 ± ∓
負	負 -
積	積 ∏
乘積	乘積 ∏
冪	冪 ^ ² ³ ⁴ ⁵ ⁶ ⁷ ⁸ ⁹
次方	次方 ^ ² ³ ⁴ ⁵ ⁶ ⁷ ⁸ ⁹
次冪	次冪 ^ ² ³ ⁴ ⁵ ⁶ ⁷ ⁸ ⁹
平方	平方 ²
立方	立方 ³
逗號	逗號 ， ,
省略	省略 ……
省略號	省略號 ……
句號	句號 。 .
分號	分號 ； ;
冒號	冒號 ： :
頓號	頓號 、
書名號	書名號 《》《 》
井	井 # ＃ #️⃣
波	波 ~ ～ ˜ ﹏ ﹋ ﹌
百分比	百分比 ㌫
卡路里	卡路里 ㎈ ㎉ ㌍
梯度	梯度 ∇ gradient
旋度	旋度 ∇× curl
散度	散度 ∇· div divergence
拉普拉斯	拉普拉斯 ∇² ∇·∇
拉普拉斯算符	拉普拉斯算符 ∇² ∇·∇
達朗貝爾	達朗貝爾 ☐²
達朗貝爾算符	達朗貝爾算符 ☐²
屬於	屬於 ∈ ∉ ∊ ∋ ∌ ∍
正比	正比 ∝
角度	角度 ° ∠
直角	直角 ∟ ⊾ ⦝
垂直	垂直 ⊥
平行	平行 ∥
弧	弧 ⌒
空集	空集 ∅
包含	包含 ⊂ ⊃ ⊆ ⊇
並	並 ∪
交	交 🈘 ∩
或	或 ∨
反	反 ¬
逆	逆 ¬
並集	並集 ∪
交集	交集 ∩
因為	因為 ∵
所以	所以 ∴
階乘	階乘 !
直和	直和 ⊕
直積	直積 ⊗
章節	章節 §
節	節 §
段落	段落 ¶ ⁋
段	段 ¶ ⁋
頁	頁 ㌻
頁碼	頁碼 ㌻
約	約 ≈
全等	全等 ≅
小於	小於 < ≤ ≪ ⩻ ⋘ ⫷
大於	大於 > ≥ ≫ ⩼ ⋙ ⫸
遠小於	遠小於 ≪
遠大於	遠大於 ≫
小於等於	小於等於 ≤
大於等於	大於等於 ≥
不等於	不等於 ≠
不等	不等 ≠
任意	任意 ∀
存在	存在 ∃ ∄
破折號	破折號 ——
百分	百分 % ％ 💯
千分	千分 ‰
萬分	萬分 ‱
納粹	納粹 卐
埃	埃 Å
字母	字母 🔤
vs	vs 🆚
信息	信息 ℹ
